User ID,User Name,Node_weight,Reply Count,Retweet count,Like Count,Quote Count,Followers Count,FOllowerID,Follower name
3941880252,Trudginon1,7,1,3,4,0,4977,[],[]
1304985072030953473,Derek89537138,1,0,0,1,0,2,[],[]
47541931,K1k0_,0,1,0,0,0,175,[],[]
434251349,StevePender,13,1,2,11,2,417,[],[]
809231649695289346,gstrumol,0,1,0,0,0,5,[],[]
893287513,Eyleyrey1111,1,0,0,1,0,136,[],[]
1016324223294246913,RobertJ38103988,0,0,0,0,0,96,[],[]
1309983094431084544,pmhcs,1,0,1,0,0,3,[],[]
3115189952,Avaaustin16,0,0,0,0,0,326,[],[]
605388398,new_hollowers,1,0,0,1,0,889,[],[]
1215492275951693824,DennisF15320203,1,0,0,1,0,27,[],[]
1330327576594714625,Fr_eedomForever,0,0,0,0,0,73,[],[]
879138490272710657,MrJoeMilliano,35,10,0,35,0,3694,[],[]
25224393,andyswats,3,0,1,2,0,508,[],[]
1298668303980859393,luna16777216,0,1,0,0,0,62,[],[]
76420972,ophirjim,0,0,0,0,0,4,[],[]
273866147,JaredDuBois,0,0,0,0,0,40,[],[]
2475407894,hugolowell,2678,280,1043,1635,211,123582,[],[]
1326333471631929344,GNucals,0,0,0,0,0,58,[],[]
34393176,Maurice4642522,10,1,4,6,0,1569,[],[]
2255711659,donaldlittle16,0,0,0,0,0,668,[],[]
1314335557695275015,chisholm_jared7,1,0,0,1,0,13,[],[]
1520453432,37outof42,0,0,0,0,0,85,[],[]
626132949,kephafan,0,0,0,0,0,188,[],[]
400419867,995mu,0,0,0,0,0,254,[],[]
33145879,yopasta,42,0,11,31,0,10177,[],[]
2316751902,lawriter33,8,5,8,0,0,3654,[],[]
915403080698445825,RancherHills,8,0,1,7,1,2678,[],[]
729846700249120768,realist2016jlp,18,1,4,14,2,8734,[],[]
3889959557,ac_actual,0,0,0,0,0,25,[],[]
1193375090680958976,sana91983188,4,2,1,3,0,77,[],[]
192308757,Sportking734,0,0,0,0,0,1745,[],[]
300646004,InternetVisitor,4,0,1,3,0,204,[],[]
1313625713837314048,HartsockJodi,0,0,0,0,0,14,[],[]
1139294395486887938,HectorJ54517947,0,0,0,0,0,6,[],[]
705204981645725698,BaffinbayAngler,1,0,0,1,0,21597,[],[]
940344632,JayGoonetilleke,0,0,0,0,0,2742,[],[]
27073181,HydroThought,0,0,0,0,0,287,[],[]
28367971,madtris,3,0,0,3,0,562,[],[]
509213346,beck7535,0,0,0,0,0,9,[],[]
1139972123567505409,TimCoys,1,1,0,1,0,357,[],[]
932799466846990336,JG_SBALending,0,0,0,0,0,654,[],[]
1015164319,LiflngfanJw,0,0,0,0,0,337,[],[]
3199991231,Stubby0207,2,0,0,2,0,42,[],[]
1340119456735875072,BRgOEPmtidbYZTu,0,0,0,0,0,17,[],[]
845008742,Richard14483002,0,1,0,0,0,21,[],[]
1256027890547937280,Robert__Stage,6,1,2,4,0,1171,[],[]
395644291,SandyPhelps1,0,0,0,0,0,28,[],[]
1373462214,beadoz,3,0,0,3,0,4103,[],[]
34050524,guitar_vet,0,1,0,0,0,163,[],[]
17921988,kmccarthy11,0,0,0,0,0,467,[],[]
1313667118773293057,AMANDATATNICHOL,0,1,0,0,0,37,[],[]
1305909315493130242,FlowersEnglish,0,0,0,0,0,16263,[],[]
627898115,russianbot3392,0,0,0,0,0,309,[],[]
626813099,CraigCongress,0,0,0,0,0,11,[],[]
1158945397,mattsupercooper,0,0,0,0,0,8,[],[]
70341249,IM_GODZFAVORITE,1,0,1,0,0,346,[],[]
1302209721273913344,Ap0calypseRadio,0,0,0,0,0,211,[],[]
2194787041,bringmecheese,0,0,0,0,0,260,[],[]
1284587187439378433,Velma47673077,0,0,0,0,0,1251,[],[]
267526813,debcolemichaels,1,0,0,1,0,10,[],[]
2222405341,VFC_C,0,1,0,0,1,945,[],[]
1344462191660052481,truthfulPATRI0t,0,0,0,0,0,0,[],[]
53162642,RN4US,73,9,46,27,18,3582,[],[]
23119815,Blowe48,0,0,0,0,0,1775,[],[]
1002544833905324033,bERNIEm72446049,0,0,0,0,0,73,[],[]
7389052,belledame,1,1,0,1,0,118,[],[]
931681289614385158,APhilosophae,1022,46,133,889,16,46660,[],[]
2462557230,RedHorseMama,1,0,0,1,0,132,[],[]
1055526016964329473,DisinterestedP,0,0,0,0,0,18,[],[]
700398134095147009,charlottepasco4,0,0,0,0,0,763,[],[]
1237792823124123648,edward_sprinkle,0,0,0,0,0,1,[],[]
100701580,Stop2Care,0,0,0,0,0,242,[],[]
1129449807695818752,BergvikJohnny,0,0,0,0,0,110,[],[]
2531174114,AmyJensen65,0,1,0,0,0,924,[],[]
1344106249646989313,Evelyn800122801,0,0,0,0,0,635,[],[]
1231350923659808769,ThearJim,0,0,0,0,0,84,[],[]
2391562290,sassybrina_,0,0,0,0,0,64,[],[]
119782350,TomVought,1,0,0,1,0,193,[],[]
523407706,Stewart74James,0,0,0,0,0,365,[],[]
72950144,TriciaUrban,0,0,0,0,0,448,[],[]
454475248,shlifeliberty,1,0,0,1,0,687,[],[]
1215513541744021504,HuntCongressAz,31,1,10,21,1,1159,[],[]
2891335724,wbowen333,0,0,0,0,0,19,[],[]
948319006993338368,HarleyMikeg,0,0,0,0,0,236,[],[]
749867244159528961,elleipsis_x,0,0,0,0,0,137,[],[]
15329294,lindyqb5,1,1,0,1,0,8035,[],[]
1021904917571751936,Nostremitus2,0,0,0,0,0,2,[],[]
2986282856,deucehotrod,11,3,0,11,0,2135,[],[]
1195804380965920768,heidioswald3,0,0,0,0,0,48,[],[]
850084333,HaraWayne,0,1,0,0,0,2117,[],[]
272720161,krkokusai,1,0,0,1,0,303,[],[]
974435384271630336,litecoin_bull,416,30,91,325,14,16050,[],[]
22884723,treehousetim,2,1,1,1,0,254,[],[]
1592062471,VDS2424,0,0,0,0,0,8,[],[]
819282044295516161,StuHixon,0,0,0,0,0,18,[],[]
1267422814308622337,phweber1,0,0,0,0,0,277,[],[]
1113521995424174085,lovin_q,0,0,0,0,0,17,[],[]
4704166346,MichaelKParrish,1,1,0,1,0,107,[],[]
739292684381212672,MelodieSpears5,0,1,0,0,0,1236,[],[]
1291715621139501056,diegoma31848102,0,0,0,0,0,8,[],[]
28286494,Chirruped,1,0,0,1,0,1240,[],[]
949827402590404608,JacobBGKY,0,0,0,0,0,12,[],[]
14658437,justin_kratzer,1,0,0,1,0,515,[],[]
826098849471143937,UrUnpaidPundit,898,59,203,695,28,19596,[],[]
27698118,NegativeNease,9,0,0,9,0,1094,[],[]
88869834,trudygonzales,111,2,33,78,1,16084,[],[]
758857570131902464,Pappa_Grizzly,0,1,0,0,0,4409,[],[]
1113957910156075008,ND4BETO,2,0,1,1,0,1236,[],[]
147989101,filipprl,1,1,0,1,0,16995,[],[]
13065702,chaosfilms,1,0,0,1,0,2425,[],[]
1251831339638304768,Islande02840941,0,0,0,0,0,7,[],[]
782235072950890496,RealRobSeal,2,1,1,1,0,310,[],[]
4832432715,42kiklouch,0,0,0,0,0,120,[],[]
171353488,WillJButcher,1,0,0,1,0,370,[],[]
335751143,Wiedy___,0,0,0,0,0,302,[],[]
830979755197362176,dana_simeona,0,0,0,0,0,165,[],[]
867046667786358784,US_Veteran2017,0,0,0,0,0,638,[],[]
460234366,ComeTakeThem,0,0,0,0,0,181,[],[]
710978453525413889,pacasandrs,0,0,0,0,0,452,[],[]
1251996983449071619,Frederi45369370,0,0,0,0,0,38,[],[]
2546196137,lorigalvis,0,0,0,0,0,35,[],[]
4784201477,CoBrians,7,0,0,7,0,4536,[],[]
3285326256,SamanthaHTown,1,0,0,1,0,411,[],[]
1156354639861882880,SeekingKnowle12,1,1,0,1,0,450,[],[]
1083201579816308736,Gailgadawgs,6,0,2,4,1,15315,[],[]
531647777,StoreyCarolyn,2,1,0,2,0,2090,[],[]
1691478300,kathies01,12,2,0,12,0,5490,[],[]
1231328827877535744,Debora46882624,0,0,0,0,0,211,[],[]
288388335,Shiftinthinking,1,0,0,1,0,1202,[],[]
1324154001793949696,Skiing72,0,0,0,0,0,4,[],[]
1275532920283820032,ThinkLikeMalcom,2,0,0,2,0,243,[],[]
1322286613611769856,bigfamilylib,3,0,1,2,0,86,[],[]
3951187792,fortheamerican,0,0,0,0,0,2291,[],[]
119436782,RebekahWriter,15,3,1,14,0,5228,[],[]
999385242,falconsky701,0,1,0,0,0,43,[],[]
822947245112889345,birdlegs1960,25,4,5,20,0,3310,[],[]
3164546317,MikeHill_3,1,0,0,1,0,17,[],[]
2965119760,MAGovSamAdams,1,0,0,1,0,2019,[],[]
1241055907397750784,Jobubevo,0,0,0,0,0,3,[],[]
18621835,GreenTheRev,3,0,1,2,0,5262,[],[]
943257356439310337,littleronnieb,0,0,0,0,0,12,[],[]
161783608,CzarofGuitar,13,0,4,9,0,1173,[],[]
4573145187,cdtmgr7733,1,0,0,1,0,1399,[],[]
318001151,ANBUHydroponica,0,0,0,0,0,456,[],[]
42301087,hudsonette,5,0,2,3,0,3144,[],[]
2528898546,NucksNBirds,1,0,0,1,0,357,[],[]
1324510988255797249,JustaMemer18,0,0,0,0,0,10,[],[]
1714219885,jdalonzo3,0,0,0,0,0,103,[],[]
23821472,Shreknangst,0,0,0,0,0,41,[],[]
1196255112102055938,hardunkichud_d,35,0,9,26,0,1860,[],[]
1306240601088823298,1776JAG,0,0,0,0,0,239,[],[]
27928227,odinslament,5,0,2,3,0,3832,[],[]
67109030,johnbinkov,0,0,0,0,0,94,[],[]
2917427613,johnnich88,0,0,0,0,0,561,[],[]
1274353723549126656,Eddy46295688,1,0,0,1,0,1784,[],[]
1076291542623481856,YongKhor1,6,1,4,2,0,12451,[],[]
951508994903945217,MichaeleneUSA,0,0,0,0,0,1233,[],[]
917564914734063616,weijune8,2,1,1,1,0,772,[],[]
940424988,Wayne6052,0,0,0,0,0,16125,[],[]
874610263655276544,LeeRufty,0,0,0,0,0,12,[],[]
1161411083468529666,Mousetwerx,1,0,1,0,0,504,[],[]
728381139644190721,DerferDarren,0,0,0,0,0,248,[],[]
899126186,futuresheartbae,2,0,0,2,0,535,[],[]
829906442,MrsBisMe,2,0,0,2,0,1055,[],[]
782916585933668352,orangemanlies,0,0,0,0,0,392,[],[]
825343335548145664,azdcbtx,0,0,0,0,0,7,[],[]
1259132754731642886,BanditCounty,0,0,0,0,0,111,[],[]
1028762646,bereasonable2,0,0,0,0,0,252,[],[]
516572282,mark_mbmccarthy,0,0,0,0,0,949,[],[]
389745103,iSwayMedia,0,0,0,0,0,175,[],[]
27142719,robkroese,7,6,0,7,0,9581,[],[]
1414144855,ssprokno,0,0,0,0,0,3,[],[]
49880714,rottrider,2,0,1,1,0,229,[],[]
1343965982054760448,LaurenAlan3,0,1,0,0,0,0,[],[]
823411819,PW_Mpls,1,1,0,1,0,496,[],[]
1561676840,grantholle_,1,0,0,1,0,102,[],[]
2698863720,Tdol23,0,0,0,0,0,45,[],[]
861241255623364608,jckuhl87,0,0,0,0,0,198,[],[]
115808051,ShoreProgress,0,0,0,0,1,3695,[],[]
1230663883414757376,Wikweko,7,2,3,4,0,19989,[],[]
1122802638,veganwell,0,0,0,0,0,343,[],[]
1965537134,jnunez1217,0,1,0,0,0,142,[],[]
2825211861,lapham923,2,0,1,1,0,5177,[],[]
109896539,CathyCulp,0,0,0,0,0,292,[],[]
1344404380389318659,Chai79715611,0,0,0,0,0,0,[],[]
15978129,RobbinMilne,2,2,0,2,0,1714,[],[]
22869375,LostDiva,17,0,4,13,1,16154,[],[]
921486015927406593,dbannie420,0,0,0,0,0,227,[],[]
1160000824887717893,templeton_eddy,0,0,0,0,0,18,[],[]
749699846576091136,Terry1sm,0,0,0,0,0,188,[],[]
429394776,KerbyCourt,0,0,0,0,0,73,[],[]
881018405481988096,Politisourced,1,1,0,1,0,433,[],[]
921520686618722304,julia_sudylo,0,0,0,0,0,227,[],[]
3076245165,DavKind76,22,6,1,21,1,10714,[],[]
1183087039069249546,THINKINLINC0LN,5,0,0,5,0,972,[],[]
1076630610934927361,BlancoTarantino,4,0,0,4,0,1744,[],[]
1393642958,HarpsGiGisHeart,0,0,0,0,0,887,[],[]
44115004,jaerokpak,0,0,0,0,0,9,[],[]
1007397473420238849,rosathina,0,0,0,0,0,185,[],[]
2167744081,jeva617,0,0,0,0,0,5,[],[]
1951853000,wanttobeonline,0,0,0,0,0,56,[],[]
1013233394577215488,night_owlll,7,3,0,7,0,1065,[],[]
1061403041226743809,dj_schubert,0,0,0,0,0,139,[],[]
1331764187496812544,LazyDai59720391,0,0,0,0,0,3168,[],[]
321052993,richurd_,10,0,1,9,0,577,[],[]
888504070411091968,11Jkr,1,0,0,1,0,16,[],[]
797202720067198976,donalarene,0,0,0,0,0,537,[],[]
986356435691991040,Thomasdiscerns,0,0,0,0,0,563,[],[]
983074246950731776,pAtriotZunite,0,0,0,0,0,243,[],[]
3068909292,Watchman1007,4,0,1,3,0,4964,[],[]
914007470,Linked333,7,2,1,6,0,3279,[],[]
855889458226380801,recedinghairlip,7,2,0,7,0,453,[],[]
4219500194,MattimioDezi,0,0,0,0,0,251,[],[]
45399457,Headoverclouds_,0,0,0,0,0,357,[],[]
35674112,Geno1957,0,0,0,0,0,134,[],[]
269263763,CrotchetyMan,0,0,0,0,0,1001,[],[]
466913608,DontTryThatHere,0,0,0,0,0,94,[],[]
1246144648122433546,ItsMeFlashE,0,0,0,0,0,397,[],[]
370226224,emmersdro,0,1,0,0,0,279,[],[]
18104074,peterkaminsky,0,0,0,0,0,1454,[],[]
1829154972,ScottAlanBuss,2,1,0,2,0,294,[],[]
1254479974867841025,Jjwansch2,0,0,0,0,0,10,[],[]
829364568644165632,Joseph_Wade400,1,0,0,1,0,130,[],[]
1318356840737050624,SusanMa83969686,0,0,0,0,1,35,[],[]
60566718,TheWorkWiz,1,0,0,1,0,149,[],[]
1339980773739249665,thebeardedmich1,0,0,0,0,0,0,[],[]
149366822,ptguy2001,0,0,0,0,0,545,[],[]
3834650237,AnnAhmerican,5,0,1,4,0,2079,[],[]
1344525828,g_tminus1,2,1,1,1,0,388,[],[]
423174701,MikeFlipp,0,0,0,0,0,110,[],[]
104493815,ExecCareerCoach,7,1,1,6,0,4036,[],[]
2257313079,tplesh7,1,0,0,1,0,421,[],[]
1254196760219656194,HuntandFishOhio,1,0,0,1,2,162,[],[]
1340696551,drygulches,0,0,0,0,0,77,[],[]
1324634731409928192,BeeCare8,0,0,0,0,0,1,[],[]
21096992,mrwntsome,0,0,0,0,0,63,[],[]
1344344728008011780,t1127BGTFD21,2,0,1,1,0,0,[],[]
18374426,Chad_EH,0,0,0,0,0,596,[],[]
47942715,peaceyomommy,0,0,0,0,0,45,[],[]
507877806,ViewFromWise,4,1,2,2,0,15111,[],[]
1121850576877363200,Lawrenc67811629,0,0,0,0,0,18,[],[]
58862740,RitaHis,4,0,2,2,0,1224,[],[]
1681541581,MommaLonda07,0,0,0,0,0,574,[],[]
1069058513685626881,EZClimateGuy,1,1,0,1,0,890,[],[]
48240668,Phofi,0,0,0,0,0,48,[],[]
318596061,EsotericPixie,9,5,0,9,0,1427,[],[]
1253023435816656897,GreeksForTrump,10,1,3,7,0,935,[],[]
245902212,JOHNNYyyzFLL,2,0,0,2,0,7012,[],[]
1153369389862936580,Klaeold,0,0,0,0,0,12,[],[]
601026186,kenfromga,2,0,1,1,0,3252,[],[]
1256974098,TheDaneMen,2,0,0,2,0,2770,[],[]
2218271960,Kyle35875855,0,0,0,0,0,111,[],[]
2615797298,ShadyPlanes,13,4,0,13,1,6388,[],[]
789951468371521536,StewardshipAmer,332,16,79,253,14,38357,[],[]
1287032751284248581,TerpstraThea,0,0,0,0,0,0,[],[]
1290286521497591808,ShaneeeJ4,0,0,0,0,0,350,[],[]
210383661,Lasvegashub,19,2,4,15,2,1942,[],[]
388679952,Pottopher1,0,0,0,0,0,178,[],[]
694649764332199936,julesorlen,0,0,0,0,0,2,[],[]
1961047700,anne_vis,0,0,0,0,0,352,[],[]
1040068606250373120,DVKvision2,0,0,0,0,0,176,[],[]
775004695,bigfatty112,0,1,0,0,0,227,[],[]
1010298833346101248,Thedarkcrimson1,2,0,1,1,0,28,[],[]
803340094522396672,AmericanGirlSD,10,0,1,9,1,3159,[],[]
3165338383,GoUncut,0,0,0,0,0,844,[],[]
2894491825,IamRoKnows,0,0,0,0,0,308,[],[]
19066632,ramocc,1,0,0,1,0,378,[],[]
1085313820883480576,Ronrashell1,0,0,0,0,0,0,[],[]
898301964722819073,US_Marj,1,0,0,1,0,2975,[],[]
76458215,colincovert,2,0,0,2,1,1103,[],[]
1250053930538729475,THEEKIRASADE,0,0,0,0,0,3644,[],[]
1330201,LisaSabinWilson,4,3,0,4,0,26034,[],[]
253637278,_YvonneBurton,76,5,20,56,1,13105,[],[]
2997224417,jkre1244,7,1,2,5,0,461,[],[]
331932428,Lady_Lear,7,1,1,6,0,777,[],[]
59171389,MYKIDSEZMOM,0,0,0,0,0,1260,[],[]
1311331952952250368,MargaretAUGrad,4,1,0,4,0,8295,[],[]
1316785182347853824,RedTrumpWarrior,0,0,0,0,0,887,[],[]
33120727,GabiStevens,1,0,0,1,0,1242,[],[]
827562434219094020,HolywoodHatesUS,5,4,2,3,1,10234,[],[]
1053272553916121089,MichaelALovett3,0,0,0,0,0,137,[],[]
335395396,MarkAnthony2021,13,3,4,9,0,9162,[],[]
1332169248127344645,Fallout73011377,0,0,0,0,0,370,[],[]
1278848505256312833,JonKatzShow,62,8,12,50,0,13971,[],[]
829837916788584449,bee_langbein,0,0,0,0,0,1642,[],[]
4839872717,ellahoward271,11,3,4,7,1,8763,[],[]
1111429252958904320,Merkabah31,3,0,0,3,0,926,[],[]
15671215,reluctantcynic,1,0,0,1,0,427,[],[]
1103001718558609408,BernieLights,1,0,0,1,0,239,[],[]
1258759500229521410,Gordonami64,0,0,0,0,0,1407,[],[]
1290425161167056898,wallemby,0,0,0,0,0,92,[],[]
37813045,RossMcleanSec,9,2,4,5,0,4771,[],[]
1877576682,nu2fl123,2,0,1,1,0,1532,[],[]
709127787571970049,Layna2802Rose,0,0,0,0,0,836,[],[]
949827397116981248,Eulisis5,0,1,0,0,0,33,[],[]
539294795,TheBondGuy2,0,0,0,0,0,952,[],[]
21379566,sue_deee,0,0,0,0,0,10509,[],[]
28366310,DailyFXTeam,8,0,5,3,0,143020,[],[]
896765953,carbonlolly,1,0,0,1,0,6375,[],[]
347347462,JKDAnthony10,9,0,1,8,0,1529,[],[]
2855241102,sext_haley_eliz,0,0,0,0,0,394,[],[]
363106057,PiratesSmile45,2,0,0,2,0,170,[],[]
2361062454,Gypsy48174,0,0,0,0,0,376,[],[]
1146524726,GWNPresents,3,0,1,2,0,284,[],[]
1206341764749115392,SeafraMicheal,0,0,0,0,0,1,[],[]
93056772,dan7gtar,0,0,0,0,0,625,[],[]
864995516395827200,FeasterFamine,0,0,0,0,0,1856,[],[]
807034591529893888,los_draco,1,0,0,1,0,348,[],[]
31465891,pithy_1,0,1,0,0,0,96,[],[]
1312873843355275264,Chris_LynnF,0,1,0,0,0,6,[],[]
1342496454909308930,makeupasystem,36,1,5,31,0,1098,[],[]
3189492086,billbarnett65,3,0,0,3,0,4276,[],[]
156332766,U_MustFight,12,2,3,9,0,82,[],[]
120135759,Lconti1970,4,0,1,3,0,709,[],[]
152847542,leislgirl,1,1,0,1,0,352,[],[]
61776465,spencer_josh,0,0,0,0,0,432,[],[]
1265483269136621568,Q_2_B_FREE,1,0,1,0,0,1492,[],[]
1266845415502012416,RichesonCarol,0,2,0,0,0,2656,[],[]
21009502,Cheyne55,0,0,0,0,0,945,[],[]
1197567573572718592,leiter_robin,5,1,1,4,0,4213,[],[]
1323161851597901826,RemoWil83995271,0,0,0,0,0,0,[],[]
1157764334291968002,flippedfromdems,0,0,0,0,0,746,[],[]
96118073,prayfreefuture,0,0,0,0,0,354,[],[]
390415463,Cozmosus,0,0,0,0,0,366,[],[]
1061761128772947968,ROAD_KING_LADY,1,0,0,1,0,2601,[],[]
266421213,stevennixxx,0,0,0,0,0,94,[],[]
31176713,Ertischek,0,0,0,0,0,416,[],[]
1292346368355446784,PasadenaJay,0,0,0,0,0,43,[],[]
1289007557688856577,KimmyDawnQDN,0,0,0,0,0,250,[],[]
20292060,BrandonCee,0,0,0,0,0,867,[],[]
1264289505823129601,MarranNichol,0,0,0,0,0,2,[],[]
1213967551195013120,Brian02163188,2,0,0,2,0,793,[],[]
924225838433914880,bytehead11,0,0,0,0,0,1,[],[]
18957779,asydlow81,1,0,0,1,0,194,[],[]
51194864,territiffany1,0,0,0,0,0,3631,[],[]
1321037827337957378,jeanhil63067006,0,0,0,0,0,0,[],[]
1005207092,dougerichards,1,0,0,1,0,192,[],[]
1315464815863885824,camerika0,0,0,0,0,0,571,[],[]
1160317927050088449,GodmotherMs,0,0,0,0,0,32,[],[]
25345298,KingAwesomeDawg,1,1,0,1,0,489,[],[]
1426767558,WaymooMoody,9,0,1,8,1,1622,[],[]
994370624,2SLiKOfficial,0,0,0,0,0,78,[],[]
722775086,Pikaclicks,298,1,1,297,0,68269,[],[]
877229477868298240,GardeniaCoast,0,0,0,0,0,1792,[],[]
939418273061335040,order1914,16,0,2,14,0,10496,[],[]
16533843,dum_belle,2,0,1,1,0,141,[],[]
48495293,jdeuce78,0,0,0,0,0,1374,[],[]
1717048800,feazel_john,0,0,0,0,0,1,[],[]
2149729027,E_Cready,4,1,0,4,0,260,[],[]
191684345,AdamKellyFA,4,0,0,4,0,600,[],[]
1195456421116043270,DenaePFA,21,0,0,21,0,6237,[],[]
4917456893,NFTsAnonymous,1,0,0,1,0,43527,[],[]
1311779918313918465,Templar74683475,0,1,0,0,0,67,[],[]
1296266025411977217,B_R_AI_N,4,0,2,2,0,34,[],[]
1042503543616401409,o2bkool,0,0,0,0,0,0,[],[]
796193583208562688,nj_colmenares,3,0,1,2,4,1255,[],[]
706674273318875136,LaBeyard,3,0,1,2,0,3072,[],[]
1313640381981040640,jessenicky1,0,0,0,0,0,14,[],[]
224508909,KarenAmma,0,1,0,0,0,17,[],[]
1201626273065439233,TextbookCharles,1,0,0,1,0,107,[],[]
95654929,caseybegin,0,0,0,0,0,1,[],[]
16480984,LadyFlannery,0,2,0,0,0,1008,[],[]
1068942968030208000,HookeyGolfer,20,0,5,15,0,4938,[],[]
1215037854826553344,johnnyr40821566,1,1,0,1,0,654,[],[]
30203539,jaball,16,0,3,13,0,12910,[],[]
3237266263,yeatts_james,0,1,0,0,0,63,[],[]
1176612614698176512,AbducteesT,0,0,0,0,0,1780,[],[]
494283547,SCS7385,0,2,0,0,0,213,[],[]
1267618162310180864,GhostlyLotus,0,0,0,0,0,30,[],[]
31011106,itshengsolo,0,0,0,0,0,54,[],[]
3921996263,XabinOtter,0,1,0,0,0,79,[],[]
892829561284694016,RobinGerry,1,0,0,1,0,69,[],[]
20538442,KennethHoefle,14,4,4,10,1,4938,[],[]
1721186430,t_donaldson101,1,1,0,1,0,33,[],[]
45946875,JoAnnRaffield,2,0,0,2,0,208,[],[]
475311497,MakerGene,0,0,0,0,0,774,[],[]
2863064337,20dumpsterfire,3,0,1,2,0,475,[],[]
910848727610470400,Spookykisstwit1,0,0,0,0,0,3,[],[]
887208954,AuntBethanyGris,0,0,0,0,0,291,[],[]
298805436,ib_2cute,1,0,0,1,0,4693,[],[]
1087592369761837056,DEANNAR83972645,2,0,1,1,0,70,[],[]
821476864325812230,AverellBrown,0,0,0,0,0,0,[],[]
873672209688080385,Covfefe76,9,1,4,5,0,2209,[],[]
25837289,BernardKerik,113854,5035,20595,93259,2704,276502,[],[]
260398846,andyfurniss,67,7,9,58,3,2429,[],[]
892479646335475712,DrPol7,2,1,1,1,0,9361,[],[]
1248997236790431744,AngieTCHTTR,0,0,0,0,0,324,[],[]
1280999394687549440,CrossTheNews,1,0,0,1,0,134,[],[]
1602349704,LargeCoffee2Go,2,0,1,1,1,6259,[],[]
1270848925671587840,realsusanalbers,2,0,1,1,0,15661,[],[]
1269677228146778118,BLESSALLUSA,0,0,0,0,0,7376,[],[]
204484980,sargep,0,0,0,0,0,509,[],[]
749986071954526208,Bappercat,0,0,0,0,0,290,[],[]
4331531667,HerLaptop112,6,0,2,4,0,2021,[],[]
408823206,NoltG,0,0,0,0,0,954,[],[]
1274021920342761472,EdselStanford,0,0,0,0,0,2,[],[]
165093903,spengy1,1,0,1,0,1,169,[],[]
1886674237,jordanprincess2,3,0,1,2,0,245,[],[]
2279226035,mannesage,1,0,0,1,0,1016,[],[]
1226904838786682880,Ken57784764,2,0,1,1,0,1186,[],[]
838899252,Adicto_al_agua,7,3,2,5,1,29,[],[]
2724731,ImMarek,0,0,0,0,0,1406,[],[]
1168014737583460359,ScrubClub13,1,0,0,1,0,57,[],[]
795656532067282944,TinkerinMD,0,0,0,0,0,459,[],[]
1321601157672951808,Michael55552720,0,0,0,0,0,0,[],[]
2806225993,WinnieTwigg,0,0,0,0,0,4,[],[]
59857273,DebbiePBolton,1,0,0,1,0,295,[],[]
1311126242012418049,MMar66029890,3,0,1,2,0,9,[],[]
1032756893264097280,bluntme22iah,1,0,0,1,1,115,[],[]
4274910195,CARogersNo1,0,0,0,0,0,2915,[],[]
762096368,SaltyBlackBroad,30,6,3,27,3,16217,[],[]
700153586706206720,_Unicornsfyeah,0,0,0,0,0,185,[],[]
3255678006,grandmagrit,1362,74,205,1157,40,40761,[],[]
1310311763561201666,caliborn858,3,2,1,2,0,325,[],[]
628136017,frogsgirl2016,1,0,0,1,0,824,[],[]
14912815,ronashively,2,0,0,2,0,1840,[],[]
1242542433629503491,JJoyaMagdalena,0,0,0,0,0,206,[],[]
1253827138857381889,fan_tolkien,0,0,0,0,0,5595,[],[]
1703766901,siqxsiqxsiq,2,0,0,2,0,618,[],[]
342067171,pinklocoroco,0,0,0,0,0,2043,[],[]
157412005,dddrop_the_lace,10,0,0,10,0,7206,[],[]
716699339620556800,trumptrainstark,1,0,1,0,0,342,[],[]
1318638723639148553,AnnPatt20880207,3,0,0,3,0,69,[],[]
333723667,WealthyWelfare,0,0,0,0,0,8,[],[]
907355254957715457,carlosgutierrez,14,0,3,11,0,3207,[],[]
1005803383293464583,PostvM1,0,0,0,0,0,227,[],[]
2919208912,drdebdrdeb,1,0,0,1,0,3385,[],[]
135584611,spareparted,1,0,0,1,0,673,[],[]
1155362642183065602,TheSeerRequiem,0,1,0,0,0,12,[],[]
17773224,ivantweetspucks,1,1,0,1,0,1229,[],[]
982886946,Loves22forYou,2,0,1,1,0,0,[],[]
2922264913,idiocracydotcom,0,0,0,0,0,20,[],[]
45550344,DeanSorenson,0,0,0,0,0,1905,[],[]
1270501956189138946,Josephi09873452,3,0,1,2,0,642,[],[]
1154719235886735361,anthony_debenny,0,0,0,0,0,1,[],[]
984126445596246016,ElTucker123,1,0,0,1,0,109,[],[]
1279306429,DanielleStipe,7,0,0,7,0,293,[],[]
1294965339881721857,t__hanes,0,0,0,0,0,39,[],[]
1085215556935008256,niffinandback,0,1,0,0,0,142,[],[]
831664071586041861,brianraby93,0,0,0,0,0,4432,[],[]
237093455,skylerjgilbert,2,1,0,2,0,719,[],[]
63986438,bkschibear01,0,0,0,0,0,131,[],[]
1252309489971273728,BEWABB,0,1,0,0,0,3,[],[]
52775978,jbird009,0,0,0,0,0,310,[],[]
1302679113954717707,anttoretu,8,2,0,8,0,639,[],[]
2997305451,nowhere987,0,0,0,0,0,353,[],[]
772891776671682560,SteveTiger999,435,43,64,371,11,11905,[],[]
2413503104,ejmiller20,1,0,0,1,0,141,[],[]
1499775464,MsAlachuaCounty,2,0,0,2,0,6086,[],[]
16109287,ryyple,1,0,0,1,0,61,[],[]
89820928,mitchellreports,1049,43,159,890,19,1974171,[],[]
1322546814772514819,DavidLe37570363,0,0,0,0,0,0,[],[]
764966687611293696,DoodyGiuliani1,0,0,0,0,0,1954,[],[]
163972276,Chrisssnnn,0,0,0,0,0,416,[],[]
61045998,dcdamiani,0,0,0,0,0,456,[],[]
3248436331,schmellga,13,0,4,9,1,1109,[],[]
16703895,gerraf,0,0,0,0,0,102,[],[]
877988358,christy_goff,0,0,0,0,0,31,[],[]
4584282501,nursiegal75,0,0,0,0,0,6673,[],[]
1583928696,mtwomedia,0,0,0,0,0,27,[],[]
895347487233462272,SavingAmerica4U,122,13,19,103,4,23806,[],[]
1257325628988157952,sarawallace50,1,0,0,1,0,189,[],[]
16445043,barryckushnir,0,0,0,0,0,592,[],[]
803829614032330756,Sob916,214,12,49,165,7,5483,[],[]
48758380,purposedrivenl,6,0,2,4,0,3541,[],[]
231090140,M26Nat,0,0,0,0,0,188,[],[]
17577058,YouMayCallMeJay,1,1,0,1,0,611,[],[]
1251289682492764160,Kat38602339,0,0,0,0,0,18,[],[]
951618127204438017,MaribethKuglen,0,0,0,0,0,81,[],[]
931298248773586944,NuggetScrapper,0,0,0,0,0,528,[],[]
246843811,4paulryan,11,1,0,11,0,6346,[],[]
956777022977662976,liberty41020,0,0,0,0,0,72,[],[]
775122854828318720,TheRamMusic,0,0,0,0,0,81,[],[]
906956370,thx3188,1,0,0,1,0,254,[],[]
1088581417393709057,PamelaS26824590,0,0,0,0,0,2,[],[]
29827475,MzRell,7,1,3,4,0,406,[],[]
119947210,juliusola,0,0,0,0,0,854,[],[]
112666923,ChicoBronson,3,0,0,3,0,854,[],[]
68098473,davidmachina51,0,0,0,0,0,236,[],[]
1103702028826669056,toddbizz,0,0,0,0,0,2134,[],[]
1316921267291783168,Lady122Donna,0,0,0,0,0,33,[],[]
1253405415766757377,lmtherealFlash,0,0,0,0,0,285,[],[]
1257621715385024512,MsVaccinaTurner,2,0,1,1,0,1752,[],[]
2926003947,hot_kommodity_,1,0,0,1,0,1018,[],[]
452172857,DestiGrace1,0,0,0,0,0,2597,[],[]
610919499,DaShanneStokes,101,1,37,64,2,36636,[],[]
3408485891,wazuberance,0,1,0,0,0,1026,[],[]
1525423416,joker7quinn,0,0,0,0,0,24,[],[]
1311129531097534471,JenniferNPL1,0,0,0,0,0,504,[],[]
79273581,elkMichelle,1,0,0,1,0,380,[],[]
1265406318493544448,beth_zzz,5,4,1,4,0,8192,[],[]
1549008109,cmcdittmer,0,0,0,0,0,2544,[],[]
1343227254034333699,torch_liberty,3,1,1,2,0,104,[],[]
319365952,FaithSpiritual1,28,4,4,24,1,3331,[],[]
900453568192409600,FreedmlovnTrump,1,0,0,1,0,3598,[],[]
611695967,maureen108,0,0,0,0,0,3426,[],[]
2267182394,Fbavaro1,0,0,0,0,0,24,[],[]
88228561,DrumrofTedworth,2,0,0,2,0,7898,[],[]
99793319,blax716,1,1,0,1,0,181,[],[]
916655610741100544,howienudet,1,0,0,1,0,5445,[],[]
17491445,AndyGlockner,5,0,0,5,0,26512,[],[]
937134535627612160,KnowWhatEyeMeme,45,6,6,39,0,23052,[],[]
825580236494376960,ChicoDlApt512,0,0,0,0,0,285,[],[]
125536787,KeithCRogers,2,0,1,1,0,10276,[],[]
181981280,Mrbill3626,2,0,0,2,1,360,[],[]
83412824,RWGII,0,0,0,0,0,266,[],[]
941817300,fantasmasmokes,1,0,0,1,0,161,[],[]
48656739,Kirembu,0,0,0,0,0,795,[],[]
4828245719,CYancey4,0,0,0,0,0,3,[],[]
21434801,HeartInNewYork,5,0,2,3,1,1830,[],[]
1175813428751097857,EverydayAmeric7,0,0,0,0,0,553,[],[]
602827004,agdude69,0,0,0,0,0,155,[],[]
2819481453,WillemLafluer,4,1,0,4,1,5976,[],[]
3099618372,Honey9Robin,4,0,2,2,0,1816,[],[]
66011862,oftheseas_,9,0,2,7,0,1487,[],[]
3385274615,AmericanMom0,0,0,0,0,0,832,[],[]
1244736807855697923,LW_610,6,2,1,5,1,3547,[],[]
19230598,Welloos,7,0,2,5,2,1059,[],[]
1118161932815609856,rjc69mopar,2,0,1,1,0,1079,[],[]
125542425,InWhomIsNoGall,1,0,0,1,0,398,[],[]
1337540683972960258,AaronPa26457056,0,0,0,0,0,2,[],[]
2579842441,Matthew73610025,1,1,0,1,0,898,[],[]
43609001,Jordan_here,0,0,0,0,0,599,[],[]
1242518535974326275,MultaPaucis3,0,0,0,0,0,73,[],[]
21711373,JeffNoethen,1,1,0,1,0,854,[],[]
3224525778,VehementRedhead,52,3,7,45,2,12377,[],[]
1102464412772900864,JasonOglesby3,1,0,0,1,0,86,[],[]
1046102582643642373,BookerSparticus,0,0,0,0,0,37314,[],[]
1056575364934352896,MegMurr66121444,0,0,0,0,0,36,[],[]
917812995840864256,Bluesparrow222,7,0,2,5,0,971,[],[]
14219171,LindaPatch,13,2,1,12,0,12424,[],[]
455684839,briantylercohen,23391,455,2904,20487,172,487631,[],[]
34957301,plchristian,3,0,1,2,0,9775,[],[]
2916043127,Jen_Em_Me,0,0,0,0,0,1040,[],[]
1123994542070476800,DianeGlazier1,3,1,1,2,0,483,[],[]
1335233737802604545,Blut_of_Tyrants,0,1,0,0,0,70,[],[]
2244249120,vontebomaye,0,1,0,0,0,1031,[],[]
325730564,Valgb1961,35,6,3,32,0,1980,[],[]
1017923754666541057,Kekistan_Justus,0,0,0,0,0,13,[],[]
25446957,pastorbones,0,0,0,0,0,3464,[],[]
919540187335725058,DennisRadcliff3,10,0,2,8,0,3700,[],[]
19261505,scottrobbinsaz,0,0,0,0,0,94,[],[]
106442006,falkmonster,0,0,0,0,0,0,[],[]
1258372888341684231,Cleep63367,0,0,0,0,0,119,[],[]
117274787,Haitch_Kay,0,0,0,0,0,152,[],[]
46430870,evangelismlab,0,2,0,0,0,524,[],[]
740348231297601537,RandFanshier,0,0,0,0,0,578,[],[]
959206026250682368,TeachMrOGrady,0,1,0,0,0,888,[],[]
255618153,Sano2h8,0,0,0,0,0,72,[],[]
1547042498,command0nando,0,0,0,0,0,711,[],[]
588308747,flashed12,0,0,0,0,0,887,[],[]
4857707848,dharris1542,25,1,9,16,0,2631,[],[]
792096589191852033,themarketswork,6160,147,1435,4725,104,130657,[],[]
544417932,eambir,0,0,0,0,0,8,[],[]
2580789621,masuruha2,1,0,0,1,0,1006,[],[]
2898006152,Thomasestes23,0,0,0,0,0,107,[],[]
941393289936240640,PoliticsKris,0,0,0,0,0,547,[],[]
1306623051195449346,MCrazycanuck,11,0,3,8,0,2161,[],[]
112223570,Beachsnncream,1,0,0,1,0,451,[],[]
1325117293718867971,lieske_jack,1,0,0,1,0,275,[],[]
1177598937391407104,JaneGalt2,0,0,0,0,0,915,[],[]
25406425,kgborland,1,2,0,1,0,1843,[],[]
907674646883061762,Trader_2007,3,1,0,3,0,3571,[],[]
1256632165095391233,Ninomerica,19,1,3,16,0,1659,[],[]
2348873094,DaytonaRaised,0,0,0,0,0,150,[],[]
1567205904,EdnaPolichnia,0,0,0,0,0,89,[],[]
205885839,mymymoni,1,0,0,1,0,1332,[],[]
967772587366469633,BlueZdw111,0,0,0,0,0,302,[],[]
1378022582,WOYMRadio,0,1,0,0,0,296,[],[]
449426046,ThisIsTheTea,0,0,0,0,0,935,[],[]
2866022840,RobertDumaine,90,13,12,78,3,7198,[],[]
1483883426,DavidWe18019162,1,0,0,1,0,2916,[],[]
1220140279493275653,LarrySphincter,1,1,1,0,0,3,[],[]
31441265,flagolfer25,0,0,0,0,0,341,[],[]
3762073452,plantoprosper19,0,0,0,0,0,1603,[],[]
785299859435773953,Thereseinpdx,4,1,1,3,0,2428,[],[]
637327317,DerfBackderf,125,5,9,116,1,10011,[],[]
991578427,JohnH4Christ,6,0,0,6,0,3535,[],[]
366205762,LukeDouglas49,0,0,0,0,0,30,[],[]
162199848,ISH_205,3,1,0,3,0,2804,[],[]
50922245,MILI14,0,1,0,0,0,979,[],[]
1247223374717296647,TheInsiderPaper,15,0,4,11,0,146255,[],[]
3349241,TimFullerton,16,0,5,11,0,16896,[],[]
1152962246592483333,SeanCra57756411,4,0,1,3,0,2368,[],[]
46915310,ShoutingStreet,3,0,0,3,0,391,[],[]
1266570548877942790,GirlMercari,0,0,0,0,0,112,[],[]
4054001539,albert1776,5,1,2,3,0,9440,[],[]
241302740,tarapoppie,1,0,0,1,0,87,[],[]
2182374548,lexonthebeach__,5,0,0,5,0,476,[],[]
1176888647787995136,trickynickydoc,0,0,0,0,0,154,[],[]
1324155152203419650,GustavZales,0,0,0,0,0,37,[],[]
391630545,janetlee93,1,0,0,1,0,206,[],[]
4511663594,cjaaaysteeze,3,0,1,2,0,57,[],[]
50875502,mrssalcido,3,1,1,2,0,246,[],[]
134762700,llReconll,10,1,3,7,0,1781,[],[]
590360871,momma4america1,0,1,0,0,0,3625,[],[]
3053626872,debg_deb,1,0,0,1,0,724,[],[]
905522376,pfitzisrobin,1,0,0,1,0,223,[],[]
498934140,swanson1954,8,2,1,7,1,3088,[],[]
1295675797315948545,Tejaspro1,0,1,0,0,0,141,[],[]
1236190927,MusicianStudio,6,0,0,6,0,190,[],[]
1258816051531390978,ADAPAC1,0,0,0,0,0,49,[],[]
107615137,Owlmanyeyes,0,0,0,0,0,739,[],[]
292680246,the_texasbob,0,0,0,0,0,202,[],[]
1323338658745929730,Edubest67362935,0,0,0,0,0,5,[],[]
826101886390525952,TheCenteredEgg,46,2,10,36,2,16484,[],[]
45192850,staffordgang,0,0,0,0,0,474,[],[]
828706394073395201,LetAmericaVote,106,1,26,80,2,96267,[],[]
786016396555784193,Votes4America,0,0,0,0,0,2759,[],[]
3722926336,jane_spillane,0,0,0,0,0,1200,[],[]
151598719,CaptainAbsolut3,0,0,0,0,0,2281,[],[]
399352443,donthebear,0,0,0,0,0,5381,[],[]
3177342025,KirbyNational,3,0,0,3,0,2735,[],[]
879499251633532929,willisgilliard,1,0,0,1,0,2,[],[]
2481441623,Neptunescage,0,0,0,0,0,627,[],[]
3329834421,ForTrump,7,0,2,5,0,26069,[],[]
208369463,quierofuego,0,0,0,0,0,1488,[],[]
238790789,ag_ramsey,1,0,0,1,0,442,[],[]
842124835245416452,jercom421,4,1,0,4,1,2934,[],[]
84208940,hfuller3,0,0,0,0,0,107,[],[]
620596234,LenDiGiovanni,0,0,0,0,0,65,[],[]
3309806594,lori_zagorski,0,1,0,0,0,21,[],[]
2323513374,EkenaCoxEpic,0,0,0,0,0,264,[],[]
4788065626,Scout_VC,0,0,0,0,0,14,[],[]
1088532156622798854,LizzyLinMac,1,2,0,1,0,6187,[],[]
912719028761894912,kirstenrnigh,1,0,0,1,0,171,[],[]
782973869653012484,LARGESSE9826,15,1,3,12,1,5726,[],[]
1290065108,bretvv,16,1,5,11,0,1726,[],[]
19305822,pkimery,0,0,0,0,0,1245,[],[]
1252968485623336961,SuzanneEllerNC,0,0,0,0,0,49,[],[]
721715626679533568,no_compute,0,0,0,0,0,238,[],[]
882686986959630336,therealbrianrw,1,1,0,1,0,28,[],[]
448397742,kidoday,0,0,0,0,0,19,[],[]
1330294493908709382,CaptainRe1,0,1,0,0,0,362,[],[]
61793272,BengalDave,0,0,0,0,0,42,[],[]
32818744,amy10361,0,0,0,0,0,350,[],[]
382691414,DemocracyInn,2271,118,507,1764,77,24129,[],[]
1143337860273266690,BatkingFinalMix,0,0,0,0,0,146,[],[]
2605676312,dannyyy33,1,1,0,1,0,42,[],[]
1264249829296934915,Huntz08912067,0,0,0,0,0,0,[],[]
587761233,12emma30,90,16,8,82,0,3385,[],[]
22542822,Williamjkelly,17,1,6,11,0,8038,[],[]
1038613670740127744,ganja_medicine,0,1,0,0,0,653,[],[]
88587587,z_beckner3,2,0,0,2,0,664,[],[]
1262051658747580418,CM36777001,0,0,0,0,0,127,[],[]
1339665188895780867,GeorgeB41586251,0,0,0,0,0,1,[],[]
824408784692994048,navycporet,6,0,1,5,0,1910,[],[]
527121146,Mella_Rose3,0,0,0,0,0,563,[],[]
756205094996176896,NightmareAlt,0,0,0,0,0,174,[],[]
1258779924736823296,TheTrut00189982,0,0,0,0,0,45,[],[]
820661510972309504,PaulMcFarland20,0,0,0,0,0,37,[],[]
2606312398,somegal446,9,0,1,8,0,12694,[],[]
2663637452,tnisha_soaps,5,0,0,5,0,2576,[],[]
1269300815363223552,ArtyEnglish,8,1,3,5,0,1211,[],[]
4639413136,marklutchman,10040,133,2363,7677,121,233699,[],[]
824318972313145345,StevanHThompson,1,0,0,1,0,6,[],[]
971927263917871104,Gwolf8958,5,0,2,3,0,1279,[],[]
2752679677,StanTALL_,4,0,1,3,0,1432,[],[]
1211283876758188034,angelaw01940918,0,0,0,0,0,2,[],[]
2970903594,bfs465,1,0,0,1,0,1368,[],[]
1225213168357650432,Cliffor36397741,2,0,0,2,0,1837,[],[]
393271504,Smallism_org,0,0,0,0,0,2038,[],[]
326412173,ChrisCJackson,84,4,10,74,0,14935,[],[]
521109951,BasilisMyName,0,0,0,0,0,305,[],[]
15771644,Randy6767,2,2,0,2,0,20790,[],[]
1169317197799464961,NickB09121299,4,0,1,3,0,3541,[],[]
27633847,dannyantell,18,0,7,11,0,6517,[],[]
1281220215376949249,glenn11181949,2,0,1,1,0,1,[],[]
2768557979,pchenderson_LV,0,0,0,0,0,6355,[],[]
2165355702,_Lightninglee03,4,0,0,4,0,1067,[],[]
114015870,CostantiniWHear,4,2,2,2,0,1587,[],[]
623026222,GrowingBack,1,0,0,1,0,61,[],[]
866824419078848513,ScottMy20278797,0,0,0,0,0,184,[],[]
796218662512427008,SwankThink,9,0,0,9,0,1310,[],[]
56587129,buckbacon,0,0,0,0,0,325,[],[]
348589112,tedc300,51,3,18,33,2,7510,[],[]
818830485593866240,Brandi_Buchman,239,7,69,170,8,32687,[],[]
1158895904356802561,Happybo47135920,0,0,0,0,0,2,[],[]
1218988377267212295,SouthernRebel_X,12,2,1,11,0,1142,[],[]
3260091684,sfunderburk_tx,0,0,0,0,0,351,[],[]
380149388,lia_cal,3,1,0,3,0,344,[],[]
701126455,URFree1809,1,0,0,1,0,394,[],[]
1337376754961428481,ACC77277,0,0,0,0,0,150,[],[]
1960741136,Debjhills,0,0,0,0,0,27,[],[]
67924209,RoadRaider3,2,0,0,2,0,396,[],[]
2305443709,orion_greg,0,0,0,0,0,8,[],[]
3014241847,stixlives,0,0,0,0,0,1803,[],[]
4252918257,will_motion,0,0,0,0,0,2989,[],[]
1326479375106154498,CasanovaFranke7,0,1,0,0,0,16,[],[]
4767314658,wish_johnny,0,0,0,0,0,141,[],[]
1340375251717402625,SassSquash94,1,0,0,1,0,25,[],[]
63473893,Lawwoman99,0,1,0,0,0,157,[],[]
3947025803,bridget_joy_,209,451,38,171,38,50759,[],[]
59621062,dearsusanbranch,57,7,5,52,1,14186,[],[]
3241707920,FriendEden100,132,86,44,88,14,32566,[],[]
1280628391377547267,AnnyeongJessie,1,0,0,1,0,27,[],[]
16561857,tooronlists,1012,23,155,857,5,8410,[],[]
371740458,GeoffreyWeiss,0,0,0,0,0,749,[],[]
718867830037282816,Johncarrick14,0,0,0,0,0,3,[],[]
731171734292992000,damo724,1,1,1,0,0,25,[],[]
1323366342238466048,PhalkeViraj,0,0,0,0,0,0,[],[]
21857709,JENin140,15,7,3,12,0,8847,[],[]
24389170,Blk_JanisJoplin,1,1,0,1,0,182,[],[]
3982440153,mywishtou,1,0,0,1,0,13,[],[]
811016334742061056,FloridaBlueDem,3,1,1,2,0,6755,[],[]
750845167339384832,gartbak,7,1,0,7,0,223,[],[]
27995424,johncardillo,15852,1353,2333,13519,512,278601,[],[]
125340503,VileManor,0,0,0,0,0,84,[],[]
101742763,BibiCheval,2,0,0,2,0,1896,[],[]
179218353,scarylawyerguy,54,1,15,39,1,13221,[],[]
1045677686,SBellerwi,0,0,0,0,0,65,[],[]
1289195731421728768,LuckyLaRue5,1,0,0,1,0,507,[],[]
4872926559,Mitchellmurphr3,0,0,0,0,0,128,[],[]
4327767617,MHutchinson1111,0,0,0,0,1,830,[],[]
888129417297276934,Kristinheart64,3,0,0,3,0,2240,[],[]
824963596958457856,CRBsteve,2,0,0,2,0,2063,[],[]
50770631,cfcdk,0,0,0,0,0,4699,[],[]
1276752657617690624,JuliaAnnaHarve1,1,0,0,1,2,6,[],[]
883062631338303488,westend999,3,0,0,3,0,980,[],[]
22791133,BootlegCo,1,1,0,1,1,205,[],[]
371802320,lostdeath1234,0,0,0,0,0,60,[],[]
1639199582,stevhez46,15,1,6,9,0,247,[],[]
262948804,moughthere,3,0,0,3,0,10186,[],[]
29514563,Dmess16,3,1,1,2,0,2340,[],[]
1276394412969390086,Ronart71,0,0,0,0,0,495,[],[]
876769731776327680,Adamadamant1111,4,0,0,4,0,3231,[],[]
719521896245669888,urmidastouch,5,1,0,5,0,125,[],[]
1319157010265370624,Tnazman2,0,1,0,0,0,1,[],[]
2508654990,Briez1,0,0,0,0,0,13,[],[]
1339303538770456576,Anthony99031745,0,0,0,0,0,2,[],[]
2626968820,rhodyred2014,0,1,0,0,0,222,[],[]
967364007240679424,sandyhewett71,0,0,0,0,0,1145,[],[]
1040091554378145792,BelcheroweT,42,7,13,29,0,2333,[],[]
798846092,StormsOnErie,0,0,0,0,0,2455,[],[]
1328911104530149379,JamesVeit5,1,0,0,1,0,19,[],[]
964977589432430592,filmbeatzzz,2,0,0,2,0,493,[],[]
217293823,Miller111601,0,0,0,0,0,6,[],[]
13544232,JeffHReynolds,0,3,0,0,0,4273,[],[]
1177439542921445377,EricG1247,114,5,14,100,2,153227,[],[]
925569365033889792,Matt81814770,0,0,0,0,0,47,[],[]
2458593661,rcritelli1,0,0,0,0,0,743,[],[]
1120076002154172417,DeliveredGenius,0,0,0,0,0,5,[],[]
1342286468610322432,DavidTrumble4,1,0,0,1,0,11,[],[]
826210403977949184,ellearee,1,0,0,1,0,217,[],[]
17090413,Chippishere,0,0,0,0,0,985,[],[]
1322323421628424192,Patrick97248218,2,0,0,2,0,12,[],[]
23699532,briangrobertson,1,0,0,1,0,1016,[],[]
10955942,FollowMal,10,0,0,10,0,2988,[],[]
708516897818591232,tgreene319,1,1,0,1,0,6281,[],[]
970057410755813376,jtyler220,4,0,0,4,0,2104,[],[]
1225891990950367232,JohniePlayboy,0,0,0,0,0,248,[],[]
67568866,nasaAsukai,0,0,0,0,0,214,[],[]
941142333541806080,princessniaa_,0,0,0,0,0,201,[],[]
2303494273,jerryreedjr,12,0,0,12,0,1252,[],[]
561488407,debbie_swords,0,0,0,0,0,38,[],[]
596138721,LoriHolyokeWade,0,0,0,0,0,358,[],[]
14976428,UtahOSB,0,0,0,0,0,108,[],[]
461491027,fr4nc15_93,4,0,0,4,0,791,[],[]
2471225112,BethKaplin1,4,0,0,4,0,2667,[],[]
775323578849857536,ChangeAbout1,1,0,0,1,0,653,[],[]
788105590262366209,saviorcrashes,0,3,0,0,0,26,[],[]
918680455410368512,A_B_W_III,0,0,0,0,0,13,[],[]
1284340398157004800,KeySh1ft,0,0,0,0,0,2,[],[]
32647651,Morticianette,0,0,0,0,0,187,[],[]
80692548,Clampitts,1,0,1,0,0,21,[],[]
1309153500065148938,JoDe22615028,0,1,0,0,0,605,[],[]
752022270617350144,HooligansfromCO,2,0,0,2,0,904,[],[]
2358197857,DavidKasuba,0,0,0,0,0,9,[],[]
1110359707,PussyFootinBlog,1,0,0,1,0,1057,[],[]
1046499520480256000,MattPrinciple,2,1,0,2,0,258,[],[]
726263825981296640,whaley_linda,3,0,1,2,0,687,[],[]
98080926,Brainmetry,2,1,0,2,0,436,[],[]
22349078,TDSDoctor,3,0,2,1,0,823,[],[]
360058863,JasonFarrJokes,2,0,0,2,0,644,[],[]
1021542313,Renea_Tide,0,0,0,0,0,1064,[],[]
1269981570133344256,DonFagan8,3,0,1,2,0,37,[],[]
803686502014316544,srbija_eu,0,0,0,0,0,470,[],[]
715032913365057536,2012mrdz,2,0,1,1,0,2490,[],[]
1249080283665551360,Lisa_DenUp,6,2,0,6,3,175,[],[]
1197654267437432834,ANNIESheridan7,3,0,0,3,0,98,[],[]
3589003512,17_3_161815214,37,3,6,31,1,9846,[],[]
1003846679131541504,GorgesSteven,9,2,0,9,1,2815,[],[]
864903879644909569,Qawwakke,0,0,0,0,0,231,[],[]
885287396581023745,AlAlfonzo1,0,1,0,0,0,93,[],[]
2236224961,TheMetDet,0,0,0,0,0,1005,[],[]
239279033,ahmadsungazer,0,0,0,0,0,432,[],[]
31559952,MirabaiGrace,0,0,0,0,0,792,[],[]
2480757588,ShellyB0918,0,0,0,0,0,238,[],[]
310485886,EricMcCaffrey,0,0,0,0,0,95,[],[]
1072438621,bitterboi93,1,0,0,1,0,416,[],[]
1082284429026967552,GolfinBum,2307,40,330,1977,17,2319,[],[]
2889291480,PennyPhoward,0,0,0,0,0,402,[],[]
1223415641421512704,Conquis86871254,0,0,0,0,0,1670,[],[]
1291391794027126787,patriot_active,3,1,0,3,0,1994,[],[]
822637992,LikeaBawwstin,5,1,0,5,0,306,[],[]
897202433247428608,LolaOnThePath,3,0,0,3,0,5137,[],[]
506724248,xdoorman,0,0,0,0,0,468,[],[]
19401317,lovesanimals,1,0,0,1,0,3677,[],[]
1314285131847340038,JamesDHicks2,0,0,0,0,0,0,[],[]
1267576165025398785,jardiniernormie,3,1,0,3,0,529,[],[]
1146683221,imapopsensation,1,0,0,1,0,206,[],[]
1329218432584327173,JeffreyAllanSm2,0,0,0,0,0,7,[],[]
399709997,wayjones,0,0,0,0,0,3067,[],[]
1230695409116467200,TimH_Tech,0,0,0,0,0,3,[],[]
1053479734007549952,NobodyButNori_,5,1,2,3,0,440,[],[]
910363625646444544,sabe14137271,0,0,0,0,0,3,[],[]
741009411204730880,WhyThHellNot,0,0,0,0,0,342,[],[]
1168008428444217344,MRWickBabaYaga,0,0,0,0,0,0,[],[]
757743403769528320,tdewitty27,0,0,0,0,0,424,[],[]
1242961969507897344,TrimHoof,2,1,0,2,0,845,[],[]
2800213719,BSevent91,0,0,0,0,0,40,[],[]
4748970015,jb4_cle,0,0,0,0,0,295,[],[]
24995895,SaturDRE,0,0,0,0,0,2672,[],[]
2891183291,daverave1954,0,0,0,0,0,6,[],[]
3418984737,KosmicEyeCandy,0,0,0,0,0,468,[],[]
637263180,chriistiiee75,0,0,0,0,0,1170,[],[]
977187147852763136,DObsiye,1,0,0,1,1,964,[],[]
1272378805282377728,GamlielMarom,0,0,0,0,0,5,[],[]
18132171,Nosynewsy,0,0,0,0,0,2527,[],[]
2696030905,Autistikids,0,0,0,0,0,562,[],[]
778077812,m16cb,2,0,0,2,0,1022,[],[]
366575137,ToniC8,34,1,7,27,2,24112,[],[]
1612373516,D2Dimeji,0,0,0,0,0,459,[],[]
2190495912,jnorthern29,2,0,0,2,0,18946,[],[]
36093,BRoodman,3,1,0,3,0,1711,[],[]
17756694,lynngg,5,0,1,4,0,878,[],[]
1223039624819478534,KevinJFoley2,0,0,0,0,0,63,[],[]
552821881,nwgsrider,20,2,5,15,2,17774,[],[]
756945394978787328,allwhite4ever,0,0,0,0,0,1672,[],[]
916114570833551360,Beard_Vet,2010,43,277,1733,52,44900,[],[]
2398138445,amarino68,0,0,0,0,0,1221,[],[]
1330598097282424834,Trumpwonbigly1,11,1,2,9,0,5281,[],[]
1229716224101228547,SwatiGu33814832,1,0,0,1,0,1498,[],[]
16862695,GabeMoralesVR,0,0,0,0,0,815,[],[]
16916446,HRCDemocrat,12,0,1,11,1,2468,[],[]
22245854,kyliepuff,4,0,1,3,0,209,[],[]
3295287420,dale1chair,5,1,1,4,0,1532,[],[]
4442964208,maryamericaj3,0,0,0,0,0,349,[],[]
376520314,TayIored,0,0,0,0,0,284,[],[]
1100565465351548930,JrBridgedale,0,0,0,0,0,44,[],[]
363343461,SophteeRossMD,1,2,0,1,0,434,[],[]
1212842856970248192,beckieavery4,14,5,0,14,0,13312,[],[]
3359640911,nayoaphoto,2,0,0,2,0,741,[],[]
1323645080574590976,RobertS65119524,0,0,0,0,0,36,[],[]
1251672208440619008,DFwrend,0,0,0,0,0,4,[],[]
286140007,mltollefson,9,0,0,9,0,371,[],[]
13801522,doozerblake,12,2,0,12,0,1810,[],[]
37093938,Elaine6342,0,0,0,0,0,2665,[],[]
250414526,M_411_,0,0,0,0,0,384,[],[]
1150978953487761409,Ndread3,0,0,0,0,0,195,[],[]
4104811095,sherilla4,13,0,5,8,0,2604,[],[]
3817980620,KoldCashGov,0,1,0,0,0,406,[],[]
90417125,sidhrtha,0,0,0,0,0,26,[],[]
313031863,PZavinsky,0,0,0,0,0,43,[],[]
15445129,jeffpearlman,41,2,3,38,0,69681,[],[]
1170960194861289472,BrainOrigami,5,0,1,4,0,2001,[],[]
932923914,JayBish1102,1,1,0,1,0,178,[],[]
833837992728993793,BillyGEdwardsch,30,22,5,25,5,24579,[],[]
135609186,g_mecca,1,0,0,1,0,18,[],[]
398331428,Cpinga3,0,1,0,0,0,201,[],[]
1280309788396699650,ChuckP54610700,0,0,0,0,0,15,[],[]
870135105045573635,OrganicCucumber,5,1,0,5,0,1393,[],[]
261174847,paolomossetti,15,1,2,13,0,3062,[],[]
47769618,CounselorCarol1,3,0,0,3,0,4198,[],[]
171240769,photobobbarnett,2,1,0,2,0,420,[],[]
772939655364739073,threadmaxwhispe,1,0,1,0,0,627,[],[]
1223316381397065728,RaleighRitter78,0,0,0,0,0,41,[],[]
908906790376689669,SilentlyFedUp,0,0,0,0,0,96,[],[]
336852370,AntonyaSantiago,0,0,0,0,1,117,[],[]
284439488,Talkeetna101,5,1,1,4,1,5464,[],[]
49690284,TPJhawk,0,0,0,0,0,4352,[],[]
2492877258,bronwyn1140,12,1,3,9,1,5475,[],[]
979513121541967873,LindaKost53,8,0,4,4,0,5450,[],[]
434458299,GavinWax,25,3,4,21,1,39047,[],[]
1122750955982708736,Jeff_operator,0,0,0,0,0,1794,[],[]
340761082,AKMandolin55,0,0,0,0,0,671,[],[]
1046440241396101143,LarryTa53175556,2,1,0,2,0,1036,[],[]
1108920276,polTrash,0,0,0,0,0,359,[],[]
1340705048834297856,BillBraskey15,1,1,0,1,0,3,[],[]
489806767,Eli_NoManning,0,0,0,0,0,787,[],[]
20900096,ashopson,0,0,0,0,0,553,[],[]
1271839625494102018,KJdaBull,0,0,0,0,0,136,[],[]
889143716,iamrhondamary,1,0,0,1,0,8058,[],[]
706670044693073920,Luckyloo16,0,0,0,0,0,7,[],[]
252165928,eclipsethis2003,15,11,4,11,0,13111,[],[]
825476542478303233,Homeoffree61,39,2,11,28,1,19102,[],[]
133915253,torispears,0,0,0,0,0,590,[],[]
309346221,Camille324,0,0,0,0,0,22,[],[]
1268886132709785600,africans_trump,0,0,0,0,0,639,[],[]
871868565552586755,AmDigitalNews,12,5,4,8,2,2182,[],[]
355041948,m_magnuson,0,0,0,0,0,101,[],[]
60215121,endtheinsanity,0,1,0,0,0,67,[],[]
1021742683440799745,Patrioteddv,61,4,21,40,2,5586,[],[]
1203823528182575104,Compuglobalhyp1,0,0,0,0,0,1259,[],[]
1046615358,amyliztweets,8,0,2,6,0,2261,[],[]
2277837434,JesusMFnChrist,0,0,0,0,0,110,[],[]
2998828049,FWreimagined,0,0,0,0,0,6,[],[]
31607289,amy_mariska,1,1,0,1,0,694,[],[]
1313667156643635200,notKevinAllred,22,2,4,18,1,311,[],[]
868207986061197312,Jonathan_Ufi,0,0,0,0,0,1341,[],[]
781916827198758912,aDiamondbarron,3,0,2,1,1,0,[],[]
1325634087781085185,sagemrad,0,0,0,0,0,55,[],[]
3852381695,SensualGemss,0,0,0,0,0,12858,[],[]
61558438,johnnyrwhitsett,5,1,2,3,0,17184,[],[]
57833910,gregory4unme,9,1,4,5,1,3527,[],[]
1208877368737247232,LastPatriot1776,0,0,0,0,0,56,[],[]
945145880549707781,MoooPapa,5,3,1,4,0,38606,[],[]
500205853,MohawkMikeCats,0,0,0,0,0,9417,[],[]
32190652,senyorreporter,4,1,0,4,0,10801,[],[]
820550111558135808,sunshengyangsy,0,0,0,0,0,6,[],[]
1170213559986294785,Moxiepup16,0,0,0,0,0,1180,[],[]
1335928143882891265,Nwankwo15543571,2,0,1,1,0,483,[],[]
953294126333726720,SharonL536,0,0,0,0,0,61,[],[]
14694105,kikiteka,4,0,1,3,0,11,[],[]
1198018607013384194,robin14799784,0,0,0,0,0,297,[],[]
773211324016975876,Crush_Marxism,0,0,0,0,0,35,[],[]
11495832,karlwm,0,0,0,0,0,16,[],[]
11066612,JDawsonTweets,6,0,2,4,0,1967,[],[]
635549966,ADriftingNerd,0,1,0,0,0,291,[],[]
1031223760920211456,Cotton194,0,0,0,0,0,35,[],[]
758497054419259393,heresjo,1,0,0,1,0,1050,[],[]
66135493,Mavis1953,0,0,0,0,0,54,[],[]
1089349636630986752,TATTOOEDPRESID1,0,0,0,0,0,122,[],[]
511006601,1humano1voto,2,0,1,1,0,4519,[],[]
1336796984959590401,pirozzi_h,0,0,0,0,0,45,[],[]
1485933091,janisfulks,0,0,0,0,0,756,[],[]
990320934,WhaleCave,2,0,0,2,0,1070,[],[]
734870606,Kcamp1776,35,2,10,25,1,3450,[],[]
1088371410224013312,KnoxieLuv,2,0,0,2,0,1176,[],[]
103760972,agentlinton,2,0,1,1,0,3834,[],[]
1644659580,RealMarkKennedy,73,3,12,61,2,8609,[],[]
126816712,Rover829,10,2,4,6,6,28042,[],[]
1426466736,ShelleyBointy,5,1,1,4,0,811,[],[]
1425137954,ErodingNewZeala,1,1,0,1,0,855,[],[]
1179053293026172929,benjaminpoitier,3,0,0,3,0,5150,[],[]
797270439303249920,sienesecath,1,1,0,1,0,406,[],[]
1323371115717267457,Kevia04,0,2,0,0,0,44,[],[]
280288703,Cairo67Unedited,263,20,75,188,7,58429,[],[]
18509300,julesdc,1,0,0,1,0,1036,[],[]
1343960153675231235,EmilyJeferrer,0,0,0,0,0,18,[],[]
1337959376397561859,FuturesMan4,1,1,0,1,0,121,[],[]
38012471,EfrainFigueroa,0,0,0,0,0,210,[],[]
903137672763461633,A_nanigan,2,0,0,2,0,135,[],[]
1534542529,ConnerSwaffar,0,0,0,0,0,7801,[],[]
717803408518938625,Bill_Rhodes54,15,1,4,11,0,29068,[],[]
957025192605306880,SSanchezTV,0,0,0,0,0,1940,[],[]
156742406,globalrolf,0,1,0,0,0,169,[],[]
141681670,fuctmind,36,14,8,28,0,10453,[],[]
3333281505,TrumpWatch,0,0,0,0,1,2451,[],[]
24236120,SeanLangille,19429,1145,3976,15453,841,10158,[],[]
1161913747,Stirthemup,0,0,0,0,0,800,[],[]
1304279676735688704,DevilsA21794551,0,0,0,0,0,400,[],[]
303356417,DJTNo1President,0,0,0,0,0,6830,[],[]
3085494124,realJoelFischer,670,29,102,568,9,54747,[],[]
428415988,Kathie1718,1,0,1,0,0,5686,[],[]
245153611,trisha513,0,0,0,0,0,1293,[],[]
566206234,tomwhitehouse3,2,0,0,2,1,408,[],[]
570419085,LepineLouis,0,0,0,0,0,16,[],[]
3299120226,Ragingpencils,4,0,0,4,0,537,[],[]
847274365146116096,lenw2017,0,0,0,0,0,9,[],[]
1338285137772089346,JamesDavidHunt,1,0,0,1,0,73,[],[]
92329166,Julie_Hancock32,1,0,0,1,0,476,[],[]
732903753070809088,OneGeorgiaPeach,0,0,0,0,0,4165,[],[]
870382375905107968,fearless1348,2,0,0,2,0,6192,[],[]
827575888543903745,realnatewiggins,89,3,9,80,5,482,[],[]
827689621865717761,tokitaeII,334,21,73,261,4,25929,[],[]
2381097013,hardcorehangout,4,0,0,4,0,2278,[],[]
964610367363022848,hallaert_marc,0,0,0,0,0,1332,[],[]
14603400,picturelady1959,0,0,0,0,0,125,[],[]
4438327525,therockofwar,1,1,0,1,0,446,[],[]
1169501488458141696,yes_emwah,0,0,0,0,0,31,[],[]
2258525366,michael75205,2,0,1,1,0,1665,[],[]
470464231,CootJuice,1,0,0,1,0,5,[],[]
1054339816182161408,ParosTom,37,7,1,36,1,7934,[],[]
343102056,budolaBud,10,0,2,8,0,7742,[],[]
2583039313,Marvel0usJesus,114,1,28,86,0,232672,[],[]
194813937,mrpaulmoore,0,0,0,0,0,1648,[],[]
1232050448225521668,mikemcg65624002,8,0,2,6,0,3408,[],[]
171680227,MARCANDERSONNWO,2,1,0,2,0,5899,[],[]
1323991490088046592,Johnny88444721,0,0,0,0,0,0,[],[]
883339591490695170,andrewdgravy,0,0,0,0,0,622,[],[]
395498858,cje2015,14,0,0,14,0,257,[],[]
1137119259400839168,Matthew__USA,0,0,0,0,0,1844,[],[]
1233231037129351169,dus_aster,0,0,0,0,0,10,[],[]
1226927648518987776,coreymichaely,2,0,0,2,0,90,[],[]
1182482775594749954,WisMamaBear,12,1,3,9,0,1440,[],[]
1328854462413369344,jaredfleming93,0,0,0,0,0,64,[],[]
1269825949891047424,dingdongdotcom1,3,0,0,3,0,2,[],[]
91493976,rdt124,0,0,0,0,0,81,[],[]
29624130,puddledunk,0,0,0,0,0,1910,[],[]
1318722888,JJRush1999,10,0,1,9,0,666,[],[]
705409883827474434,kinny_nobo,0,0,0,0,0,48,[],[]
143311631,BarbiG_tea,1,0,0,1,0,1589,[],[]
1207642105465778176,hill_meek,0,2,0,0,0,191,[],[]
2900581641,WaaDooWho,0,0,0,0,0,2604,[],[]
33368576,ChaseAli,0,0,0,0,0,0,[],[]
936097285,samdcbu,1,1,1,0,0,417,[],[]
819966128,caco5031,0,0,0,0,0,9,[],[]
61886236,fantasticlegs,36,4,9,27,1,13982,[],[]
