User ID,User Name,Node_weight,Reply Count,Retweet count,Like Count,Quote Count,Followers Count,FOllowerID,Follower name
1331615817390313472,BettyAn44389108,0,0,0,0,0,6,[],[]
1222641969924648961,returnofthegoth,3,0,0,3,0,924,[],[]
29366189,Theo_Chilton,10,1,1,9,0,3110,[],[]
16704363,RogerF1953,6,1,1,5,0,2019,[],[]
1229457653300105217,kled43,2,0,1,1,0,1424,[],[]
2892985895,RoswellLisa1,4,0,2,2,0,547,[],[]
430267969,becdwo,4,1,0,4,0,1047,[],[]
18080108,tan123,24,1,3,21,0,33009,[],[]
1057374564873895941,TicoBoard,0,0,0,0,0,88,[],[]
304531027,Sonygamer1,0,0,0,0,0,111,[],[]
87983928,drlabossiere,5,1,1,4,0,1779,[],[]
1511603629,WeR1Singularity,0,0,0,0,0,164,[],[]
20238974,MsDayglo,1,0,0,1,0,3554,[],[]
1295042802628227073,MadMechanic73,0,0,0,0,0,523,[],[]
1106300702236774402,USPatri03431508,0,0,0,0,0,311,[],[]
151622477,CaroleGilman,0,1,0,0,0,1751,[],[]
810321722067062784,TonyGucciano,0,1,0,0,0,7,[],[]
1320854596563193856,baking49,2,0,1,1,0,475,[],[]
1287487807141937153,randyswish,0,0,0,0,0,12,[],[]
979112378,burns184,0,0,0,0,0,2345,[],[]
1493598763,NogrowthCole,0,0,0,0,0,3625,[],[]
939587923938127872,ChrisBesanson,0,0,0,0,1,4,[],[]
1122916383724122118,Big_Bell77,0,0,0,0,0,7,[],[]
2737523318,ApoloJedi_,0,0,0,0,0,1030,[],[]
1307103895303286785,Billy_Big_bags,0,0,0,0,0,38,[],[]
2440815536,JS1580,0,0,0,0,0,219,[],[]
733170820625928192,awb20774,0,0,0,0,1,2510,[],[]
458910009,squirrel27845,0,0,0,0,0,98,[],[]
59314724,yurkiddingme,1,0,0,1,0,1268,[],[]
1262750499809288193,gsucjc,11,0,4,7,0,585,[],[]
780544757806149632,used2bdemocrat,0,0,0,0,0,134,[],[]
235199409,FridaGhitis,40,1,4,36,1,32078,[],[]
1053747985786527744,manuelofreire,7,0,2,5,0,14500,[],[]
46480121,JCBolWag,0,0,0,0,0,1201,[],[]
146644080,azmoderate,42,5,12,30,1,20710,[],[]
1240342945821229061,RayRaysFanAcct,4,0,1,3,0,2519,[],[]
100030889,R_Leckie,0,0,0,0,0,42,[],[]
1033054369631985664,liberalsteveros,0,0,0,0,0,7232,[],[]
1373383958,nancysquinn,3,0,0,3,0,4682,[],[]
759219343104348160,NorgeDan,3,1,0,3,0,1792,[],[]
1319676750700417032,ghost_cowboys,1,0,0,1,0,788,[],[]
1021528102483238912,SyntaxXSindoll,14,0,5,9,2,1204,[],[]
1265907843569500161,gomoelineh,0,0,0,0,0,2,[],[]
555395202,PielCanela728,0,1,0,0,0,354,[],[]
20414466,breezyvibe,1,0,0,1,0,111,[],[]
1189637735356567552,TheNinerPoints,3,1,1,2,0,634,[],[]
949440876392079361,wallross_ross,0,0,0,0,0,243,[],[]
1334319015473238016,LonHudson6,0,0,0,0,0,0,[],[]
1243901864028049411,TheDon4Rushmore,0,0,0,0,0,2,[],[]
1330917447394791428,JasonBo73796385,0,0,0,0,0,5,[],[]
125855396,Renae131,1,0,0,1,0,277,[],[]
2269833908,wazzu90,0,0,0,0,0,80,[],[]
2292332876,abc_lmnop,0,0,0,0,0,912,[],[]
870309056610615297,ARGCAZ,0,0,0,0,0,831,[],[]
370468772,Greggs_nBacon,2,0,0,2,0,423,[],[]
1267340330258567168,wavechaser2024,13,0,3,10,0,6073,[],[]
936858992,sandyleevincent,245,10,37,208,14,48102,[],[]
436393281,jeffinCNY,0,0,0,0,0,250,[],[]
1014522097895239686,WarChancla,3,0,0,3,0,66,[],[]
330379313,GJDHouse,1,0,0,1,0,269,[],[]
134665136,ethanprice,1,0,1,0,0,843,[],[]
2290406826,StevenHarp_,9,3,1,8,0,2315,[],[]
729870701335695361,lizzyemcee,2,0,0,2,0,863,[],[]
21625963,julielvday,1,1,0,1,0,40,[],[]
1312740146454953987,steve53602904,0,0,0,0,0,33,[],[]
3024558601,janerv249,0,0,0,0,0,6,[],[]
67609399,SethBiddulph,0,0,0,0,0,171,[],[]
2763762198,livthes,0,0,0,0,0,9,[],[]
25513161,Black_1,1,0,0,1,0,563,[],[]
439654068,gcaustria,0,0,0,0,0,45,[],[]
943215098394501120,PaulFHiggins,2,0,0,2,0,218,[],[]
1283572037970210819,JacobLouisBaron,2,1,0,2,0,1953,[],[]
871569210161364992,Wilhelm_Husk,0,0,0,0,0,210,[],[]
251349160,SportsNoBS,1,0,0,1,0,1097,[],[]
1026923978,Maccabeus24,0,0,0,0,0,3551,[],[]
898815860,LanciaSc0rpi0n,0,0,0,0,0,10937,[],[]
956327327939645440,VirginiaLouelle,0,0,0,0,0,773,[],[]
1213072089290166273,Diogenes20203,0,0,0,0,0,615,[],[]
897115470783852549,HenryJKraven,8,0,1,7,0,6925,[],[]
1207880778253848576,DavidHi17301137,0,0,0,0,0,839,[],[]
1903167241,DavidLMadison,0,0,0,0,0,70,[],[]
925082615169761281,jpbuffalo81,0,0,0,0,0,316,[],[]
14156474,paulerickson,1,0,0,1,0,374,[],[]
3477290357,JfKness1,0,0,0,0,0,19,[],[]
550271358,Nor_toriousLKL,4,0,0,4,0,11537,[],[]
1617069110,HighRoadIsRight,0,1,0,0,0,4115,[],[]
3214714613,derekmitt,0,0,0,0,0,180,[],[]
376226841,Quest1743,0,0,0,0,0,1519,[],[]
18441277,rdgirard,0,0,0,0,0,21,[],[]
2634888579,jacobtedadams,7,3,0,7,0,97,[],[]
46448402,iamgregk,0,1,0,0,1,2434,[],[]
1089827198,MhnewmanMicah,0,0,0,0,0,8,[],[]
2810112283,Photogbill222,0,0,0,0,0,5065,[],[]
2387480084,TheBizAdvsr,0,0,0,0,0,220,[],[]
1291523849121681411,Mikewal71119451,0,0,0,0,0,1679,[],[]
4848952816,lifttheveil411,11,3,0,11,2,7762,[],[]
1328463924392505346,laugh_write,0,0,0,0,0,12,[],[]
795691817073143808,ISO_XRP,2,3,0,2,0,7897,[],[]
329122055,ljb48,0,0,0,0,0,1220,[],[]
720377783415758853,nichols_lindy,1,0,0,1,0,437,[],[]
1270912213851746310,Cindylouhoo2b,0,0,0,0,0,1066,[],[]
1324760124171472900,johnnyEByrd1,0,0,0,0,0,24,[],[]
23122779,Frank5ngls,0,1,0,0,0,153,[],[]
37842578,GSP_Exit_63,2,0,0,2,0,700,[],[]
1216215157313036294,Jpgamer62272325,0,0,0,0,0,1,[],[]
67562050,SGT_Buttercup,0,1,0,0,0,1539,[],[]
56002342,JVanderhook,0,0,0,0,0,35,[],[]
1099670362332246016,red7669,0,0,0,0,0,9,[],[]
1043963448751783938,deplorable_im,0,0,0,0,0,1893,[],[]
345235072,TheLibertonian,1,1,0,1,0,82,[],[]
2515223123,IvvanAli,0,0,0,0,0,220,[],[]
2841387292,EricDroll,0,0,0,0,0,2337,[],[]
116958320,thomasebarry,1,0,0,1,0,818,[],[]
47174053,Tomobabyka,0,1,0,0,0,380,[],[]
83051777,burntwolf,0,0,0,0,0,49,[],[]
28626894,DeimosMetus,0,0,0,0,0,2684,[],[]
23467947,tribros,0,0,0,0,0,615,[],[]
1098449300,ManDeer666,0,1,0,0,0,1400,[],[]
800000515123924992,dancer_carole,0,1,0,0,1,659,[],[]
1305514437365956609,MoseyDm,8,2,0,8,0,3804,[],[]
3189286978,JLatker,1,0,0,1,0,125,[],[]
364133958,NEWZFOX,0,0,0,0,0,711,[],[]
65540587,SKirkPierzchala,1,0,0,1,0,421,[],[]
761238040656306177,VoteEmAllOut,0,0,0,0,0,13339,[],[]
545068087,EricInfoTech,5,2,0,5,0,2901,[],[]
14976544,borroff,1,0,0,1,0,542,[],[]
1333629191288451074,freeandfair123,0,0,0,0,0,280,[],[]
531764458,nellyknn,0,0,0,0,0,120,[],[]
171591751,ullolayoga,1,2,0,1,0,4069,[],[]
449324526,90sKidd_Tevo,0,0,0,0,0,513,[],[]
854419448341688321,MTobiamo,4,0,2,2,0,47,[],[]
423943062,cfirmleader,0,0,0,0,0,45,[],[]
16395581,BeckPictures,0,0,0,0,0,172,[],[]
789293086400663552,105artillery,3,3,0,3,0,2650,[],[]
2903285387,CoryCleveland25,2,0,0,2,0,877,[],[]
57468644,4eyedmonk,2,1,0,2,1,51750,[],[]
1270392478827515908,TruthTalks12,1,0,0,1,0,143,[],[]
188619586,kingpgeorge,0,0,0,0,0,161,[],[]
462451128,mgsholaas,1,0,1,0,0,114,[],[]
715450242573971456,chiclasweet1,0,0,0,0,0,29,[],[]
14719087,KeithFlynn,0,0,0,0,0,619,[],[]
1264910690944499712,DRVIVEIROS1,0,0,0,0,0,1,[],[]
845833560611340293,exoticgamora,47,25,10,37,2,100415,[],[]
501355133,SandraHaakmat,7,0,2,5,0,2339,[],[]
1249059736823025664,SSoseti,7,1,1,6,0,396,[],[]
1139757001481654272,rottboss,2,0,0,2,0,3,[],[]
1129041755360440323,Someone97409839,0,1,0,0,0,45,[],[]
732583032033402882,TheSUMO_IRL,0,0,0,0,1,289,[],[]
374426962,OohFa,9,0,2,7,0,14570,[],[]
1201951391436169216,NolanHenderson9,0,0,0,0,0,369,[],[]
7983122,bruhsam,1,0,0,1,0,225,[],[]
3309872275,TheChulaDiaries,12,1,1,11,0,2794,[],[]
937182558541922304,MasterClassMill,4,0,1,3,0,7259,[],[]
1263881323510296582,KayBee88268682,0,0,0,0,0,647,[],[]
2331212465,b_vplants,0,0,0,0,0,412,[],[]
491448173,vicesociety1,0,0,0,0,0,3783,[],[]
386686106,LaurenHagee,0,0,0,0,0,127,[],[]
19477398,ConfuzedMind,0,1,0,0,0,264,[],[]
1254798527357693952,Cynthia43112603,0,1,0,0,1,508,[],[]
1316813466464915456,Michell93235238,0,0,0,0,0,71,[],[]
1215470867410554882,nutcrackin0,0,0,0,0,0,45,[],[]
986698024440254467,bacteri0_phage,3,0,0,3,0,32,[],[]
928477979503509504,jtnrmom,1,0,0,1,0,525,[],[]
27209858,dgdw,0,1,0,0,0,2165,[],[]
1322923699121606657,jimmyv627,0,0,0,0,0,47,[],[]
789153744696913920,watercutter11,1,0,0,1,0,6227,[],[]
2882092654,shaycooper3361,0,0,0,0,1,1915,[],[]
368431343,nettspurv,0,0,0,0,0,63,[],[]
109441206,RWSalt,17,0,1,16,0,239716,[],[]
288305906,deejayLoft,7,1,0,7,1,10332,[],[]
784881611422703616,miroslavtok,0,0,0,0,0,1161,[],[]
1316229886026092545,boar_white,0,0,0,0,0,20,[],[]
3145284671,caldy97,3,0,0,3,0,317,[],[]
58684834,fergranadino,1,0,0,1,0,185,[],[]
47632504,RickSchoonmaker,1,1,0,1,0,1542,[],[]
620269917,JnoBS86,0,0,0,0,0,135,[],[]
894745163196645377,Peggyed41450907,0,0,0,0,0,4069,[],[]
1273911011263885312,PepperJelly3,2,0,0,2,1,3506,[],[]
1001886845863694336,Elizabe62385790,1,0,0,1,0,248,[],[]
1328724862282719238,JeremyHigley,0,0,0,0,0,4,[],[]
935904696643944448,irondoctorDC,3,0,1,2,1,1377,[],[]
773422451288117249,reallybob1,4,0,2,2,0,3175,[],[]
238654354,VaughnHarper,10,2,2,8,0,2632,[],[]
4160697132,nitehawknz,5,1,0,5,0,92,[],[]
1117451811382808577,Caleb_Purcell_,0,1,0,0,0,71,[],[]
832880669781004288,IkechukwuPaul17,0,0,0,0,0,29,[],[]
1053256272894664707,Dave27057591,0,0,0,0,0,34,[],[]
29077161,JustinGrayWSB,45990,11537,5231,40759,2362,13608,[],[]
1280354542605959169,BobPark67157482,0,0,0,0,0,44,[],[]
812411262,ZoneAndonlyHo,1,1,0,1,0,273,[],[]
804845730758328320,sullyp40,3,1,0,3,0,508,[],[]
15471853,Iowans_Rock,0,0,0,0,0,2633,[],[]
889468029465223168,BenLuke14,1,0,0,1,0,2780,[],[]
440506882,SpencrGreenberg,0,1,0,0,0,9179,[],[]
950180063227588609,LiveZenLove,0,0,0,0,0,762,[],[]
1255952793673895939,VeinVigri,0,1,0,0,0,241,[],[]
3282722508,mnjkaf2,0,0,0,0,0,3777,[],[]
23541812,4for4_John,11,25,0,11,1,71865,[],[]
1186718302963453953,SmugsyGirl,1,0,0,1,0,1042,[],[]
15563362,pattykeough,0,0,0,0,0,218,[],[]
2982006207,JettSzn,9,0,1,8,0,511,[],[]
59391529,orngblu,0,0,0,0,0,657,[],[]
1043467221899653120,JaneCon80663901,0,0,0,0,0,117,[],[]
3078228027,dbeard8987,0,0,0,0,0,724,[],[]
2298491270,CPGeekee,1,0,0,1,0,263,[],[]
29597581,TeamThead,0,0,0,0,0,3118,[],[]
39155721,MLPEPPERS,2,1,1,1,0,136,[],[]
82474323,ronwass000,0,0,0,0,0,135,[],[]
182037735,JennyLaw23,2,1,1,1,0,934,[],[]
378401999,campbell_elroy,1,1,0,1,0,1101,[],[]
346090051,engtuffy,0,0,0,0,0,5,[],[]
23749865,Thingumbobesq,0,0,0,0,0,146,[],[]
1318992190627078145,FeistyPK2,43,11,7,36,1,34690,[],[]
1308398022586511369,MellTime,2,1,0,2,0,105,[],[]
1073299041746870272,sticksnstones88,0,1,0,0,0,14,[],[]
83926452,Jason_Bender,7,2,2,5,0,904,[],[]
42429470,ncarter11356,0,0,0,0,0,106,[],[]
244621333,MRICTPET,7,9,0,7,1,13419,[],[]
28459974,ScottSaia23,9,2,1,8,0,7499,[],[]
1245427239338102785,Badged_Patriot,41,0,15,26,2,4004,[],[]
2919066758,wayston_ur_tyme,0,0,0,0,0,1572,[],[]
816652616625168388,RepAndyBiggsAZ,1357,79,177,1180,35,396549,[],[]
1291409308643667970,Kimberl31598137,0,0,0,0,0,0,[],[]
44402121,CaptainLouie,0,0,0,0,0,5593,[],[]
1925103650,yebisu02010514,1,0,0,1,0,293,[],[]
3246378511,realpolitikwest,0,0,0,0,0,790,[],[]
306399777,pdrp57,0,0,0,0,0,11,[],[]
1475201581,mamacubs1,0,1,0,0,0,1155,[],[]
2988949910,__signals,0,0,0,0,0,2524,[],[]
1326745959724933121,GrandsonsL,0,0,0,0,0,19,[],[]
875495350840291329,TheBasedViking,0,1,0,0,0,63,[],[]
1724085200,onyinyechi__,1,0,0,1,0,709,[],[]
713184504194678784,Jack_Burton33,0,0,0,0,0,1076,[],[]
3884325279,mjhall0854,3,1,0,3,0,2257,[],[]
2478647197,TommyIsBS,0,0,0,0,0,229,[],[]
981957793904242693,So_it_flows,1,0,0,1,0,556,[],[]
15509954,NathanLands,51,2,10,41,1,6896,[],[]
112268028,ppriesse,2,1,0,2,0,1106,[],[]
17996997,nickolashook,0,0,0,0,0,96,[],[]
243711520,MikeMcLean123,0,0,0,0,0,1209,[],[]
738382537525972992,anarchy_dot_gov,5,0,0,5,0,4769,[],[]
27232477,D2TheCizzle684,1,0,0,1,0,114,[],[]
1308071009451298816,KG8614,0,0,0,0,0,2,[],[]
1286335963,AxisMann,0,0,0,0,0,1,[],[]
243968556,LiddleSavages,0,0,0,0,0,2273,[],[]
871436467863605248,TonyBoscoe,1,0,0,1,0,8531,[],[]
174749100,UCCowboy,0,1,0,0,1,892,[],[]
933448112219348992,OutsourcedVfx,0,0,0,0,0,76,[],[]
802264526020378626,hockeyfan2824,0,0,0,0,0,142,[],[]
18087796,chris_churchill,8,1,4,4,1,8334,[],[]
1324205782540423169,andA_report,0,0,0,0,0,5,[],[]
1008139113596375040,ryanmcdusa,0,0,0,0,0,605,[],[]
52132209,SDKit,0,0,0,0,0,2731,[],[]
952875902676930560,oosterbaum,0,0,0,0,0,2543,[],[]
1294737735366844417,JaneBla82609630,0,0,0,0,0,674,[],[]
776393884448555008,Elaines72172172,1,0,0,1,0,1150,[],[]
65146404,Laguna_Corgi,3,0,1,2,0,46,[],[]
1249720966550339584,carrieL75669689,0,0,0,0,0,189,[],[]
3162889279,dimundking,1,0,0,1,0,16,[],[]
177530324,Ed_Renehan,1,0,0,1,0,1158,[],[]
938227747,brn_ann,1,0,0,1,0,529,[],[]
1215360409722597377,JWeinbuch,0,0,0,0,0,13,[],[]
565405241,michael86028714,0,0,0,0,0,16,[],[]
591441680,DeanaKindt,0,0,0,0,0,293,[],[]
19399022,DigsRetro,0,0,0,0,0,614,[],[]
29681555,Gesuschic,2,0,0,2,0,328,[],[]
132230870,Rlpt41,0,0,0,0,0,31,[],[]
57049338,DebbieAAldrich,167,39,45,122,21,61156,[],[]
613876677,GoBigGavin,3,0,0,3,0,1728,[],[]
1332440143551148032,MarkTheRepub,0,0,0,0,0,0,[],[]
1294102736087035904,MLittmar,1,0,0,1,0,135,[],[]
2978191714,SteveKoehler22,25,0,8,17,1,18149,[],[]
199770246,Orwellian_EU,29,4,1,28,0,7568,[],[]
2788247797,TheRealCLJC19,0,1,0,0,0,3828,[],[]
345146131,grandsoba,0,0,0,0,0,146,[],[]
3931283419,JoshuaBHoe,9,0,1,8,0,13410,[],[]
1318158648590409728,iiirightiiiii,4,1,0,4,0,445,[],[]
1300978572077694984,RufusHall13,0,0,0,0,0,17,[],[]
2889928393,GibbinsGregory,0,0,0,0,0,167,[],[]
307215176,GollyMollyB,0,0,0,0,0,606,[],[]
894186849408778240,PaulStorms60,0,1,0,0,0,2,[],[]
1228462620,ndrew_lawrence,186,3,18,168,0,58230,[],[]
4137767542,JonWelbornNC,0,0,0,0,0,1354,[],[]
1069826229006753792,TheSwedishElfIX,0,0,0,0,0,55,[],[]
1488120901,Thetechnician28,0,0,0,0,0,442,[],[]
1300120221278187521,TrumpIsSatan2,1,0,0,1,0,1,[],[]
60435440,CGAdamo,25,2,9,16,2,7982,[],[]
627710672,SenChrisLarson,44,10,8,36,0,5475,[],[]
3409962065,exTrumper,0,0,0,0,0,1,[],[]
1316930344558485505,BrotherBill14,0,1,0,0,0,352,[],[]
320241951,dawnerichards,8,3,1,7,0,4708,[],[]
30180885,BorisTrucco,0,0,0,0,0,5029,[],[]
1093906876922777601,SCommies,0,0,0,0,0,97,[],[]
1252036361915453442,MaiorisTacet,0,1,0,0,0,46,[],[]
151831177,TheMarianWay,0,0,0,0,0,290,[],[]
486980068,AlM0n3y,2,0,1,1,0,37,[],[]
58801323,psoko09,1,0,0,1,0,367,[],[]
116271446,bridgetgarraway,5,1,0,5,1,617,[],[]
1281358428087164932,GRUFPASA,0,0,0,0,0,13,[],[]
136359277,stevebyrnelive,59,9,6,53,0,51318,[],[]
16322711,ericfacas,3,0,0,3,0,2321,[],[]
959377300889526272,AgateSeaWolf,0,0,0,0,0,220,[],[]
833725018924265472,RepublicansPAC,0,0,0,0,0,42,[],[]
432831307,LwyrwithAPPEAL,0,0,0,0,0,2060,[],[]
2220625540,24chauncy,0,0,0,0,0,51,[],[]
147821958,sbroo11,1,0,0,1,1,10,[],[]
191243427,NVPatriotGirl,1,0,0,1,0,3650,[],[]
462104542,chuckwoolery,2165,34,219,1946,27,556032,[],[]
2480877074,AgAmgran,0,0,0,0,0,158,[],[]
2680680497,Mossberg_JS,0,0,0,0,0,284,[],[]
1075435179907473408,ericcgarneau,9,0,0,9,0,435,[],[]
292736703,Lowe_160,0,1,0,0,0,422,[],[]
51310693,ConnorWexler,0,0,0,0,0,168,[],[]
886698085258338304,LorraineD888,0,0,0,0,0,460,[],[]
56142265,whoisrayroberts,0,0,0,0,0,361,[],[]
1334644536086290432,CthulhuSwims,0,1,0,0,0,1,[],[]
834624548364484608,ShadesOfShay,25,2,3,22,0,6770,[],[]
171267518,reddawns,0,1,0,0,0,1863,[],[]
818617963695652864,DrMichaelFugate,0,0,0,0,0,4,[],[]
2944538610,4ndresCastr0,2,0,1,1,0,212,[],[]
4197113232,FrostyTakes,19,1,4,15,1,1710,[],[]
1279276719887843328,TonyLog98116443,0,0,0,0,0,2,[],[]
164386441,Road_2_Ft_Worth,3,0,0,3,0,230074,[],[]
1316489783171059712,shmederalist,0,0,0,0,0,23,[],[]
714819958962790401,cyberph0enix,1,1,0,1,0,158,[],[]
535498658,lf9685,0,0,0,0,0,852,[],[]
883443023081877505,RobertBucking20,2,0,1,1,0,3531,[],[]
4149340160,j_zonker,3,0,1,2,0,1340,[],[]
718294286,twit_mhyg,0,0,0,0,0,326,[],[]
820244174,cgallegos3,2,0,0,2,0,862,[],[]
1100494594050019328,wheelerspoerner,3,0,1,2,0,125,[],[]
3995741428,TacomaPatriot20,0,0,0,0,0,1108,[],[]
409658798,TemiaBrinson,9,1,0,9,0,10729,[],[]
2991316649,CollinDems,1,0,0,1,0,1902,[],[]
1180029398,jw0672,0,0,0,0,0,2055,[],[]
816656863144067074,BelindaBinnabb,0,0,0,0,0,41,[],[]
807998957708115968,FireTrumpToday,6,1,1,5,1,10068,[],[]
263939670,Riverdogs2020,0,0,0,0,0,16,[],[]
1191555549294399488,ives_hunter,1,0,0,1,0,9,[],[]
1332444889007665157,LuisFue31631201,0,0,0,0,0,1,[],[]
706733903999008769,LawsEdward,1,0,0,1,0,4255,[],[]
1192296453840031744,THiSiZGi0,33,2,0,33,0,1344,[],[]
890981768299388929,OneStephenGrey,1,1,0,1,0,8,[],[]
966858611375988736,ElleJMacAmerica,1,0,0,1,0,5830,[],[]
1297982138340585478,CCLPastorRock,0,0,0,0,0,18,[],[]
218307802,Milnoc,0,0,0,0,0,557,[],[]
1245698538404790277,vrinkles,0,0,0,0,0,462,[],[]
262266528,BigBangMike_,19,1,1,18,0,1445,[],[]
1248868315646373890,todie_marinack,1,0,0,1,0,799,[],[]
174830546,searscoach,0,0,0,0,0,34,[],[]
17631163,RandyTravisFox5,14,6,2,12,7,6810,[],[]
1038220316277977093,DanielGreff,2,2,0,2,0,169,[],[]
1325089705902432259,StrategyLiberty,1,0,0,1,0,93,[],[]
90307264,juiceman2006,0,0,0,0,0,49,[],[]
1305711053024624646,pattypuppet,2,0,1,1,0,60,[],[]
3052657292,eckloff_joe,0,0,0,0,0,123,[],[]
58653906,Valy_Grl,2,0,0,2,0,603,[],[]
39173899,BlackK_GMS,0,0,0,0,1,1079,[],[]
220801422,CynicalNews,1,0,0,1,0,156,[],[]
986728219347791872,Chelle_Renee_,0,0,0,0,0,547,[],[]
29110103,8ironmike,20,3,6,14,2,92,[],[]
1075763828208648193,RwSteady1,0,0,0,0,0,8,[],[]
1097907711189106689,Used_To_Be_GOP,163,3,22,141,4,20294,[],[]
1332020316558725122,AlfordMel04,0,1,0,0,0,92,[],[]
734923521520869376,flylower4,0,0,0,0,0,7703,[],[]
179695220,compendiumof_,0,0,0,0,0,181,[],[]
30315515,Susaninlaguna,2,0,1,1,0,20675,[],[]
49787356,Zero8Seventy,0,0,0,0,0,1728,[],[]
858123043150983169,DDBURNES,2,0,0,2,0,483,[],[]
520361384,7triumph22,0,0,0,0,0,222,[],[]
27703117,reigle4,0,0,0,0,0,50,[],[]
771556124,dakmosh,0,0,0,0,0,306,[],[]
742715845621735425,Hart1Mikel,0,0,0,0,0,9,[],[]
6394672,alisongrinter,132,3,40,92,6,2198,[],[]
17668502,IDoubtIt,31,7,1,30,2,7287,[],[]
62319353,talkradiodog,0,0,0,0,0,753,[],[]
4734524106,MiExecSearch,0,0,0,0,0,190,[],[]
18226424,SOThomasnet,0,0,0,0,0,2300,[],[]
799452120,TimNaftali,73,9,8,65,0,17139,[],[]
1244642603057975297,IusiMark,0,0,0,0,0,181,[],[]
552275049,_camwba,1,2,0,1,0,1491,[],[]
138088041,SchrammCBS46,29,4,10,19,2,3599,[],[]
785350207722524674,one1_victorious,1,0,0,1,1,2219,[],[]
365518250,LAinSouthernNJ,1,0,0,1,0,836,[],[]
145344816,BLACKADAM001,1,0,0,1,0,284,[],[]
1312123267499659266,tainaboricua2,0,0,0,0,0,20,[],[]
1247980901532925954,Jeff_Mont12,0,0,0,0,0,24,[],[]
1294699091281281034,realDarthYoda,1,1,0,1,0,810,[],[]
4036399460,selmarose40,0,0,0,0,0,196,[],[]
3959404755,JamesBi99729441,0,0,0,0,0,108,[],[]
2508358246,lilsparo,1,1,1,0,0,125,[],[]
15195253,RoryTyer,1,1,0,1,0,889,[],[]
16439164,toniafisher,0,0,0,0,0,64,[],[]
1268240675843309568,BryanMarple,0,0,0,0,0,3,[],[]
1234749217,CarlChurch5,0,0,0,0,0,28,[],[]
321028622,Bds399Brian,2,1,1,1,0,1484,[],[]
918272486927675392,dkDeezNutz,0,2,0,0,0,392,[],[]
27368057,southrnbandit,2,1,1,1,0,191,[],[]
48392782,chris_allman,40,4,4,36,1,5431,[],[]
911645698642280450,lucyall2,1,0,0,1,0,319,[],[]
19816130,padistedor,0,0,0,0,0,701,[],[]
1328049954049437696,OjiUkonu,0,0,0,0,0,1,[],[]
525002011,mmtrendy,0,1,0,0,0,861,[],[]
801632635,briggie3231,0,0,0,0,0,462,[],[]
29306551,Hannah_08,0,0,0,0,0,54,[],[]
863619224,glperkins4053,1,0,0,1,0,14,[],[]
1207491413270761472,WinningRight1,0,0,0,0,0,797,[],[]
1220264453482041344,sausalitohippe,4,0,2,2,0,1310,[],[]
205888155,LTMofYork,0,0,0,0,0,785,[],[]
182878105,ProtecttheFaith,43,3,18,25,1,23921,[],[]
22281821,JessicaCarynne,0,0,0,0,0,388,[],[]
73323926,arikopel,0,0,0,0,0,4734,[],[]
2348637459,CrixousB,0,0,0,0,0,273,[],[]
236967626,timgibson57,0,0,0,0,0,46,[],[]
1236382898657337346,BinaSkywalker,0,0,0,0,0,82,[],[]
1304766180117434369,Truthduckemerg1,0,0,0,0,0,181,[],[]
3192441942,PardesSeleh,120,10,4,116,1,62268,[],[]
1331969463655215104,matt52304408,0,0,0,0,0,0,[],[]
1326116713998536704,DonJabberwocky,1,0,0,1,0,10,[],[]
1218175113591431170,gordy4justice,5,0,1,4,0,414,[],[]
753741611327188992,JZ618,2,1,0,2,0,766,[],[]
1114423308919828481,koumei_flat,0,0,0,0,0,309,[],[]
242229678,t_smoove_goody,0,0,0,0,0,1272,[],[]
612151875,TheComboBreaker,1,0,0,1,0,202,[],[]
167603204,skb_sara,51,8,4,47,2,79981,[],[]
110452092,zekejwilliams,1,0,0,1,0,210,[],[]
818156090982445056,Calloradokidd1,1,0,0,1,0,1539,[],[]
770519840,Butch_Inman,4,0,2,2,0,76,[],[]
1157277186988171264,TeddyForPA,43,1,6,37,1,53202,[],[]
1686174589,Laziest_Avenger,0,0,0,0,1,2263,[],[]
798172555,robirdie777,18,4,2,16,4,5522,[],[]
827875618817613825,MaureenMoBeck,4,0,0,4,0,2916,[],[]
1071559145407594497,99_bigmac,4,0,0,4,0,35,[],[]
34613951,BLaw,9,3,5,4,2,139989,[],[]
4640585592,BrittanyinTexas,9,1,3,6,0,54755,[],[]
621441012,kellyjo0813,0,0,0,0,0,212,[],[]
975945776701624320,cory98642065,1,0,0,1,0,151,[],[]
96375146,4910947um,0,1,0,0,0,118,[],[]
181253436,mavensupdate,0,0,0,0,0,2344,[],[]
906631378133028865,PaulStraightUp,0,0,0,0,0,34,[],[]
4501779254,DavidECathey2,1,0,0,1,0,184,[],[]
828253384360722433,LucyMarcoIII,0,1,0,0,0,6,[],[]
989305818985021440,Elizabuzz070165,0,0,0,0,0,2862,[],[]
1122179167632732161,liasterling11,2,0,0,2,0,744,[],[]
1236089975894138880,ElEsteep,0,0,0,0,0,129,[],[]
770067585073381379,pjmcduffie4,0,0,0,0,0,110,[],[]
18369102,miamicuban,0,0,0,0,0,1449,[],[]
1240412518981435393,jemima_44,0,0,0,0,0,32,[],[]
1059987312417890304,DavidCo36558003,0,0,0,0,0,9,[],[]
182689505,Rush3495,0,0,0,0,0,580,[],[]
1322344491756511232,barrychastain2,0,0,0,0,0,14,[],[]
173117092,thegr8onebill,1,0,0,1,0,120,[],[]
1547017452,xpzap,0,0,0,0,0,17,[],[]
694682581221048320,iVoteAmerica,34,3,13,21,2,8320,[],[]
860077232,reveristsadboii,7,1,0,7,0,915,[],[]
1248301419993731080,Skip18528123,0,0,0,0,0,208,[],[]
1160917535254089730,layersofbs,0,0,0,0,0,236,[],[]
827560337562009601,FireOnDMtn,26,8,3,23,2,691,[],[]
848543035399036929,JelleMTroelstra,0,0,0,0,0,206,[],[]
107753087,JamesRadunzel,1,0,0,1,0,74,[],[]
214742678,NotJimPaschke,0,0,0,0,0,402,[],[]
2521093802,RainbowDoom32,0,0,0,0,0,14,[],[]
825706233457938432,vicvon66,0,0,0,0,0,7456,[],[]
1326912502442184704,Gattis2Glenn,0,0,0,0,0,77,[],[]
802346760777637888,CWWyche,0,0,0,0,0,3287,[],[]
850120089739329536,U646201tim,0,0,0,0,0,111,[],[]
1250589263474892800,AndrewClack3,0,0,0,0,0,36,[],[]
3068974437,PA_Capitol_Boy,7,1,0,7,0,1834,[],[]
1056989898400522240,KathleenHawk4,1,0,1,0,0,3552,[],[]
4144059087,StellaBellus,0,0,0,0,0,972,[],[]
714207445585776640,sands_csands1,2,0,1,1,0,403,[],[]
1283768910,waltsheppard,2,0,0,2,0,58,[],[]
39922546,ShanGoBragh,0,0,0,0,0,819,[],[]
215372913,1brightmale,0,0,0,0,0,633,[],[]
808200076355141636,rolandstedt,0,0,0,0,0,307,[],[]
94124782,PalmerPhD,0,0,0,0,0,371,[],[]
811648794458603520,rocknrik,0,0,0,0,0,1837,[],[]
835874246358405120,LindaKRagland,2,1,0,2,0,14201,[],[]
368524369,CameronSlide,3,0,0,3,0,3736,[],[]
234624358,USAF_DAV,0,0,0,0,0,496,[],[]
3095031639,torpedopolitics,0,0,0,0,0,1393,[],[]
1229032323854852097,Sarge829,0,0,0,0,0,1,[],[]
89272855,godlywomanhood,65,36,5,60,0,15339,[],[]
345013823,Rhodi1959,0,0,0,0,0,1115,[],[]
2570400970,KathrynAMurdoch,547,79,52,495,19,10105,[],[]
602843963,VirginiaYankee1,11,3,0,11,0,1192,[],[]
2840854046,niyo0n,0,0,0,0,0,211,[],[]
1331723143623413761,LibertyBeaut,0,0,0,0,0,138,[],[]
1161363002,spirehosp,0,0,0,0,0,874,[],[]
2965129619,harambe_fren,4,2,1,3,1,4718,[],[]
1333589659277029377,Nmp57113154,0,0,0,0,0,1,[],[]
135025583,str8narro,0,0,0,0,0,535,[],[]
40871064,talk2melodie,0,0,0,0,0,1628,[],[]
510172528,MichaelHSears,0,0,0,0,0,119,[],[]
1104219353254424577,anattanotself,0,1,0,0,0,70,[],[]
486902057,Raxiuscore,0,0,0,0,0,35,[],[]
848098807,LoloCraiger29,1,0,1,0,0,526,[],[]
1267850089978048518,SarahDianne0727,0,1,0,0,0,249,[],[]
852899634120978432,cmelton_,1,0,0,1,0,59,[],[]
831513484936486912,esk5212,2,0,0,2,0,268,[],[]
96168899,jimmbob699,0,0,0,0,0,966,[],[]
1415419794,CoryThreadgill,2,0,1,1,0,66,[],[]
32289481,Jerseyboi654,0,0,0,0,0,12,[],[]
2962409909,dr_rythm2003,0,0,0,0,0,223,[],[]
19403048,Timmy30,0,0,0,0,0,161,[],[]
1241798692690104321,JesseHSaunders,4,2,2,2,1,66,[],[]
457961501,SSchmidt87,9,1,1,8,0,1175,[],[]
2964744772,Cam1Eddie,0,0,0,0,0,1580,[],[]
1224784509381509122,aveeromoseleje1,0,0,0,0,0,681,[],[]
836196590,victheslickg,7,0,2,5,0,2294,[],[]
1299850807182065665,pat_delisi,0,0,0,0,0,109,[],[]
1308131075550568449,johngoo97578704,0,0,0,0,0,5,[],[]
713063879811538944,SFVDon,0,0,0,0,0,165,[],[]
1193386814809288704,DRAINSWAMPSCUM,0,0,0,0,0,2494,[],[]
1334305218599682048,ShivaWolfie,0,0,0,0,0,4,[],[]
3644915056,HunterJCullen,1361,213,129,1232,54,54759,[],[]
304410684,realcoley1,25,3,1,24,2,10558,[],[]
93841438,jff040753,4,0,0,4,0,2155,[],[]
4781123569,CallMeTiaFancy,4,1,1,3,0,3076,[],[]
1103704740809109504,jedeyess,1,1,0,1,0,12,[],[]
806289099917291520,mwpartain,0,0,0,0,0,3,[],[]
3234206654,SpeakinFromTN,4,2,1,3,0,2831,[],[]
557134247,HuffdaddyShane,24,0,0,24,0,2012,[],[]
986022930743099392,OliverWinger1,0,0,0,0,0,63,[],[]
627707606,TennesseeAubie,0,0,0,0,0,702,[],[]
757291788885340160,john_tedford12,0,0,0,0,0,14,[],[]
914967710,danajhidalgo,2,0,0,2,0,1967,[],[]
2162783491,localopinions01,0,0,0,0,0,26,[],[]
242962998,pennsyclause,0,0,0,0,0,441,[],[]
1250247477611167744,ShawnThobe,4,0,0,4,0,93,[],[]
2150802542,MarcoMNYC,2,0,0,2,0,3752,[],[]
76160055,jackielbowman,0,0,0,0,0,822,[],[]
3305566010,RetireB4IDie,13,0,1,12,1,10664,[],[]
29579007,Cyndy12,0,0,0,0,0,412,[],[]
729358274575761408,RoaryMcG6,3,0,1,2,0,51,[],[]
992692806,crystalbrooke81,0,0,0,0,0,4688,[],[]
47939438,BorisSays_,0,0,0,0,0,86,[],[]
3125452714,2_off_the_grid,26,6,3,23,0,3801,[],[]
1140677322665840640,MinistryofTru16,4,1,0,4,0,8126,[],[]
1309097782335148033,CCPisTrash,0,0,0,0,0,38,[],[]
1314249916986818560,jmorin0523,0,0,0,0,0,0,[],[]
723989560691138561,Keithpoker1,5,0,1,4,0,11069,[],[]
563790311,PoliTweetCal,0,0,0,0,0,48,[],[]
1113828112503115776,ThePubliusUSA,11290,330,2032,9258,220,111265,[],[]
3308323706,kintxzterry1,0,0,0,0,0,0,[],[]
908060282,ReaWritesrea,0,0,0,0,0,36,[],[]
968160950,Coloncx,0,0,0,0,0,317,[],[]
909491861294895105,piiimss,0,0,0,0,0,30,[],[]
3026895442,rebelrattler,0,0,0,0,0,643,[],[]
953271372,Romija54,0,0,0,0,0,65,[],[]
956988172399009792,NoOneIsNotThere,13,0,2,11,0,10328,[],[]
844637783591411712,Trelond_Skye,0,0,0,0,0,1423,[],[]
814630353415585792,maria_mu2,0,0,0,0,0,320,[],[]
418867782,K1erry,9,3,5,4,0,20057,[],[]
1319971180045107200,CornPop11006292,0,0,0,0,0,228,[],[]
1277289676609445888,pdqgreen,0,0,0,0,0,426,[],[]
752062892053147648,jasonreeve81,0,0,0,0,0,197,[],[]
2871041810,MolinskiValerie,1,0,0,1,0,229,[],[]
939993330,meWooster,0,0,0,0,0,1273,[],[]
1310029705555386368,LagrangeRocky,0,0,0,0,0,12,[],[]
26592941,Builder26,0,0,0,0,0,3311,[],[]
4745280949,LeslieEsc,113,13,11,102,4,18635,[],[]
1109577503440543747,mydepthlessgaze,4,0,0,4,1,82,[],[]
1149007733473067008,alwaysdiscerned,0,1,0,0,0,112,[],[]
820691256502321152,offyspirit76,0,0,0,0,0,1364,[],[]
833039074835496964,Richard7312495,0,0,0,0,0,731,[],[]
4855044657,ZiffyKat,7,1,1,6,0,11894,[],[]
791089925160628224,jpgwire,4,0,0,4,0,101,[],[]
1296050172452122625,BoojyWoojy,0,0,0,0,0,23,[],[]
316610789,Maphisto13,0,0,0,0,0,6,[],[]
1244745225429553158,Margie74024072,0,0,0,0,0,88,[],[]
1093243525330862085,ALepore8,0,0,0,0,0,32,[],[]
913025702,steve8022_smith,2,0,0,2,0,343,[],[]
2737880206,mikesides61,0,0,0,0,0,37,[],[]
715925714864906241,DeborahMM123,0,0,0,0,0,221,[],[]
885814590,Dmforesee,0,2,0,0,0,3,[],[]
824623111165399040,cmc_cannedeye,5,2,1,4,0,974,[],[]
817350448000729088,DumfordDavid,0,0,0,0,0,3017,[],[]
1241744895628529666,NoFaceMaskForMe,1,0,0,1,0,521,[],[]
1321345254994235393,EdwardsKagiso,0,0,0,0,0,108,[],[]
905220622736695297,harrywatkinsnm,0,0,0,0,0,5,[],[]
122914054,SusanCSchweiger,0,0,0,0,0,74,[],[]
441080463,TheDamaniFelder,3289,52,334,2955,56,168200,[],[]
1325647658367639552,Kingmade93,2,0,0,2,0,187,[],[]
2783875490,derekjames150,77,2,16,61,0,47458,[],[]
976193448171667456,perksjoanna1,1,1,0,1,0,702,[],[]
104606497,Burgesscr8,0,0,0,0,0,163,[],[]
149301036,DonnieA21,0,0,0,0,0,390,[],[]
116876723,1ens,1,1,0,1,0,870,[],[]
23790860,teknodave,1,0,0,1,0,1338,[],[]
1316791042201460740,Davidmm38330134,0,0,0,0,0,0,[],[]
1325550222575980544,vicAU_,0,0,0,0,0,232,[],[]
190165215,kungfu_mandarin,0,0,0,0,0,1685,[],[]
2455118242,KokodeKay,6,0,0,6,2,264,[],[]
1333007535851376646,AndrewRenert,0,0,0,0,0,3,[],[]
468862360,QueenVampira43,0,0,0,0,0,937,[],[]
83702577,Shannon_71,0,1,0,0,0,71,[],[]
1032486244779847681,Andrew_Muses,0,0,0,0,0,17,[],[]
1232804316249022464,usausau55211713,0,0,0,0,0,1,[],[]
3122408507,JPratique,1,0,0,1,0,3414,[],[]
15002823,athinkingman,0,0,0,0,0,1582,[],[]
17707903,Mercifull,1,0,0,1,0,1466,[],[]
1303753867977527298,Patriot_girl68,0,0,0,0,0,4,[],[]
955961020983345152,AmericanIndy77,233,12,43,190,10,10221,[],[]
1323273799807225857,DrDAVIDBANNER4,0,0,0,0,0,24,[],[]
799959965263917056,brojthompson,1,0,0,1,0,72,[],[]
414318354,BrendanHealy1,0,0,0,0,0,13,[],[]
3256269600,icethekicker,0,0,0,0,0,29,[],[]
4716008607,joeysilvanus,1,0,0,1,0,19,[],[]
273840449,CORMACCRAWFORD,0,0,0,0,0,95,[],[]
17298036,OhHaiDRol,5,0,0,5,0,1480,[],[]
116445836,AjalaYemi,22,2,11,11,1,7337,[],[]
1068306441918955520,flagfriendly,1,0,0,1,0,1178,[],[]
820068287774097412,Patrici65223591,0,0,0,0,0,45,[],[]
15956846,NawthernBelle,0,0,0,0,1,2969,[],[]
3302914956,freedomactradio,36,1,3,33,4,3188,[],[]
1281133097900179457,FacingReality10,1,0,0,1,0,3,[],[]
194046496,rossenaar,0,0,0,0,0,1464,[],[]
1056543993834565632,NitaRichard11,5,0,2,3,0,651,[],[]
1248077794313150465,Sth661,0,0,0,0,0,68,[],[]
815568842,FelisRufus35,0,0,0,0,0,33,[],[]
1262460668516667396,evonmedia1,41,3,18,23,0,244,[],[]
328184349,rmgeller,5,0,1,4,0,730,[],[]
1662358008,rjboy95,3,0,1,2,0,227,[],[]
2720593130,hoccomoccoLA,0,0,0,0,0,109,[],[]
169194976,americadiaspora,1,0,1,0,0,1384,[],[]
791123165388734464,Lex_Luthor06,1,0,0,1,0,68,[],[]
606053373,BrettGreer2,0,0,0,0,0,853,[],[]
90494411,blksands,0,0,0,0,0,0,[],[]
1182738633645801473,Collegefactss,0,2,0,0,0,7,[],[]
55172770,oybama,0,0,0,0,0,45,[],[]
910612648747610112,Danaduchess,0,0,0,0,0,3225,[],[]
1265745415489630209,cat_barakat,0,0,0,0,0,211,[],[]
710738910725275648,FluffyDogAttack,14,0,1,13,0,7066,[],[]
74184169,jayhawksubofan,4,0,1,3,0,664,[],[]
42808422,Noelle_Michaels,0,0,0,0,0,1701,[],[]
262862748,revno9lnn,0,0,0,0,0,0,[],[]
2162565316,RonitaJacobs1,0,0,0,0,0,46,[],[]
531432497,MillerMattu,1,1,0,1,0,832,[],[]
753952472369139712,HabibMboowa1,0,0,0,0,0,823,[],[]
1296255120141889536,1MoniqueWorthy,468,51,58,410,9,38353,[],[]
1031445008,M1Seamus,0,0,0,0,0,92,[],[]
25220782,RicklH,0,0,0,0,0,259,[],[]
860583816909516801,DianneAbacus,0,1,0,0,0,1211,[],[]
1033621070836887552,anvilofyahweh,0,0,0,0,0,205,[],[]
1270925701064114176,mancha_perkins,0,0,0,0,0,71,[],[]
839246996,ytrebilekatllI,0,1,0,0,0,4958,[],[]
17580134,OuterBanksGuy,2,0,0,2,0,203,[],[]
861673987,BettyAylward,0,0,0,0,0,475,[],[]
1260826475172855808,OliveBr42748782,0,0,0,0,0,214,[],[]
38507977,4mp3d,3,0,1,2,0,283,[],[]
242742017,taraheritage,0,0,0,0,0,1025,[],[]
1082907562863820800,Stickynicky17,1,0,0,1,0,1488,[],[]
1193810985640976386,pollyplacebo1,2,0,0,2,0,387,[],[]
824440252702085120,DragnetDean,0,1,0,0,0,43,[],[]
163588622,CaitiJGould,0,0,0,0,0,110,[],[]
20336210,lifebiomedguru,16,3,0,16,0,45281,[],[]
716981840,duranr86,0,0,0,0,0,128,[],[]
1011331419174420480,VegasPatriot2,3,0,0,3,0,7719,[],[]
939956101,kc11dog,0,0,0,0,0,14,[],[]
864474829,jamcat331,0,0,0,0,0,12,[],[]
796344307816996864,Cripsydamnduck,0,0,0,0,0,91,[],[]
809492101591433216,FullyBoosterd,0,0,0,0,0,41,[],[]
552293040,VStewartNYC,1,5,0,1,0,468,[],[]
2890251334,ScottishML,0,0,0,0,0,1,[],[]
1199844134745305088,BoomerOtis,2,0,0,2,0,352,[],[]
1300235383196844032,Phillip70932970,0,0,0,0,0,263,[],[]
1241942211962507269,RamjattanChris,0,1,0,0,0,27,[],[]
1079045868664303617,Riis81417347,1,0,0,1,0,389,[],[]
112953060,anymcd,0,0,0,0,0,0,[],[]
19328633,mdegs,1,0,0,1,0,657,[],[]
212707226,EyeCatcherEagle,0,0,0,0,0,34,[],[]
797827493847769088,mommabear1882,0,0,0,0,0,948,[],[]
1258083799797096448,ontherightpilot,0,0,0,0,0,41,[],[]
69596356,Xandra1117,2,0,0,2,0,2360,[],[]
1206820181449809920,JonathanNTurner,0,1,0,0,0,823,[],[]
220085558,MFL____,0,0,0,0,0,163,[],[]
1240088391573811201,LuckoTeresa,0,0,0,0,0,198,[],[]
552544245,DaveEBrooks12,8,0,0,8,0,4356,[],[]
1296110865586900994,cocogurl2020,0,0,0,0,0,256,[],[]
934989971202629632,Tango5x5,0,0,0,0,0,496,[],[]
752306418921967620,Giocamo54,0,0,0,0,0,260,[],[]
1119069275174645760,brinicole1127,3,0,0,3,0,2248,[],[]
17883102,kenlbear,0,0,0,0,0,317,[],[]
1880158741,F0RTNITE,1,7,0,1,0,1253,[],[]
1217560968772718592,squad_vice,0,0,0,0,0,24,[],[]
789185894125142016,1DesignerLife,1,0,0,1,0,1169,[],[]
42414535,1LightCreative,0,0,0,0,0,55,[],[]
1249852462166614017,IvanSexton3,0,0,0,0,0,56,[],[]
53577470,PNWgramma,0,0,0,0,0,1186,[],[]
1295158465959165953,RealTexanBob,0,1,0,0,1,94,[],[]
891653360281059329,orpheomax,0,0,0,0,0,10,[],[]
173280472,j_grenfell,0,0,0,0,0,275,[],[]
35145594,tyrannoseahorse,1,1,0,1,0,700,[],[]
1299785825945817095,TieDaytrader,39,2,7,32,0,9357,[],[]
949521227302944773,MenisinoMartin,0,0,0,0,0,139,[],[]
2344743030,thinktoomuchmom,1,0,0,1,0,2791,[],[]
1061798185100890112,tachiblade,0,0,0,0,0,17,[],[]
253121541,Dewey6868,0,0,0,0,0,53,[],[]
828736337947693056,rickbrown706,1,0,0,1,1,5,[],[]
1149477850728132608,spyderpublican,0,0,0,0,0,525,[],[]
1321319260249972736,OldManLefty1,0,0,0,0,0,12083,[],[]
1318173046453227521,Genghis75612462,0,0,0,0,0,267,[],[]
100314094,RyanHagensee,0,0,0,0,0,111,[],[]
1298688627929747458,HJones_bu,0,0,0,0,0,739,[],[]
782968940943204352,806wtx,4,1,1,3,1,410,[],[]
1182361807958237184,al16144339,0,0,0,0,0,3,[],[]
991081864487030784,queen_khalifia,1,0,0,1,0,144,[],[]
2381079758,HaleighHoffman,48403,944,6334,42069,814,7648,[],[]
316893324,TheSportsNerd92,0,0,0,0,0,219,[],[]
2842973282,johngbiggs,0,0,0,0,0,92,[],[]
3069099800,aborengasser,1,0,0,1,0,291,[],[]
4885275625,System3oh3,1,0,0,1,0,49,[],[]
16504112,sav01,7,0,1,6,0,3720,[],[]
417322024,ericfizer,0,0,0,0,0,139,[],[]
978124242817617920,brucea4444,3,0,0,3,0,60,[],[]
1296277127407509506,Shanick38,3,2,0,3,0,2281,[],[]
1124264635,golfnutian,1,1,1,0,0,1586,[],[]
37978977,SoundChaser56,0,0,0,0,0,1402,[],[]
822647838685401088,ritochespi2,0,0,0,0,0,0,[],[]
817787882395955200,harrylitman,2703,48,397,2306,26,209355,[],[]
1402860703,txshaemac,3,0,1,2,0,723,[],[]
801558991,guyknoller1,16,6,2,14,0,8635,[],[]
1190283302453665792,MericanSpartan,0,1,0,0,0,6,[],[]
16119383,Cotic,0,0,0,0,0,261,[],[]
878979532757360640,roger_chugh,1,0,0,1,0,60,[],[]
32783596,stephencvengros,0,0,0,0,0,2627,[],[]
1324563918673555461,Michael63898291,0,0,0,0,0,8,[],[]
1178078825307000832,VandykenMatthew,0,0,0,0,0,51,[],[]
112575695,DanielH187,0,0,0,0,0,285,[],[]
81915976,_drei,7,0,1,6,0,2100,[],[]
21516977,enuminous,0,0,0,0,0,3133,[],[]
1133857167331794949,davemit57767822,0,0,0,0,1,588,[],[]
2493770130,AngryandAsian,27,1,7,20,0,39607,[],[]
570436252,Captaleks,13,5,0,13,0,14502,[],[]
29286658,Senski9145,0,0,0,0,0,55,[],[]
992165610040815616,KerTopp1,0,0,0,0,0,200,[],[]
1265303770461659140,peter24300254,1,0,0,1,0,14,[],[]
54420901,yiasmin_cindy,1,0,0,1,1,3611,[],[]
871508001626234881,EllaGross0,0,0,0,0,0,53,[],[]
96772855,jinksgirl,1,0,0,1,0,1514,[],[]
889708899498119168,gracesaldanaa,35,2,4,31,1,32731,[],[]
1313364373495144449,cjburdenofproof,0,0,0,0,0,3,[],[]
1041167410496036864,packman_ja,0,0,0,0,0,4,[],[]
34304778,Crispdj,2,1,1,1,1,3717,[],[]
19226833,D______o______M,1,0,0,1,0,390,[],[]
896622942469070848,Joel_Agius1,2,0,0,2,0,2514,[],[]
1320872701599252481,patriotlady80,0,0,0,0,0,4,[],[]
17871879,MichaelBeirne,0,0,0,0,0,6,[],[]
2575626163,cantadd,2,0,0,2,0,1626,[],[]
2816168341,EpPurplegirl,0,0,0,0,0,84,[],[]
15088731,Cigahs,0,0,0,0,0,194,[],[]
1208416346171748352,MolnarStephano,1,0,1,0,0,40,[],[]
1238117757188628487,OzPatriot2020,0,0,0,0,0,112,[],[]
619309429,nancy41557,0,0,0,0,0,817,[],[]
1333914521891704832,YouGottaGoGuy,0,1,0,0,0,12,[],[]
4401167723,drew0926,0,0,0,0,0,18,[],[]
17464064,septembergrrl,1,1,0,1,0,559,[],[]
28030586,theaaronowens,1,0,0,1,0,1516,[],[]
1277987866304344064,mightygrammy,0,0,0,0,0,43,[],[]
1045863284,jonbarc,0,0,0,0,0,1463,[],[]
1326745925608464386,DJDiddleSpit,0,1,0,0,0,21,[],[]
53386965,Sammer1944,0,0,0,0,0,471,[],[]
3991176074,4urthermore,0,0,0,0,0,21,[],[]
741743875,TrumpThatBitch1,2,1,1,1,0,1559,[],[]
729148541139091456,lowiqidiot,0,1,0,0,0,97,[],[]
112047546,Pega_,0,0,0,0,0,1271,[],[]
916369857679167491,Redneckray86,0,0,0,0,0,770,[],[]
581181304,EarlYajaGreen,0,0,0,0,0,157,[],[]
786297772903235585,MilkboneMan,0,0,0,0,0,9916,[],[]
1325609110360846337,Piperviper3,1,0,1,0,0,29,[],[]
1334699995233136643,nelson40367847,0,0,0,0,0,0,[],[]
2909348840,TheMountainSon,1,1,0,1,0,405,[],[]
1185367435555299328,RavvenQ,9,1,0,9,0,146,[],[]
829910978112450560,Lpac2017,2,0,1,1,0,4202,[],[]
974441856,LUV_Recovery,0,0,0,0,0,4796,[],[]
1799312354,GetHealthy_Kim,2,0,0,2,0,156,[],[]
40930985,marksasmith,0,0,0,0,0,21393,[],[]
794187411383205888,GriffithChelly,0,0,0,0,0,2421,[],[]
1277643920751689728,JohnQOhio,0,0,0,0,0,3,[],[]
1110633761677430784,pik3id,0,0,0,0,0,22,[],[]
1431625202,samja3211,0,0,0,0,0,0,[],[]
984310403713843202,SunnySixxkiller,0,0,0,0,0,606,[],[]
1330872618665185289,StevenVanHeyni1,1,0,1,0,0,188,[],[]
708811077270708225,eyemleo,0,0,0,0,0,8,[],[]
1312417379645759488,AllysonZoellner,0,0,0,0,0,5,[],[]
1327367326052855808,lebmoreno,3,0,0,3,0,495,[],[]
583827873,EmjayMj2,2,0,0,2,0,1529,[],[]
4293989355,mrjaabrams1,0,0,0,0,0,40,[],[]
186762030,Twosidesofacoin,1,0,0,1,0,697,[],[]
1936670683,PrayingMoreRU,0,0,0,0,0,196,[],[]
1235956232369737728,jen4_truth,0,0,0,0,0,237,[],[]
1241753466579582977,Kelvin27310,0,0,0,0,0,82,[],[]
720027371747672065,JohnESm51306727,8,1,1,7,0,2278,[],[]
1292132711558152193,TheEliteDelete1,0,0,0,0,0,154,[],[]
1199563548,Sara_Stark,0,0,0,0,0,824,[],[]
1171062500042911744,117vols4life,0,0,0,0,0,234,[],[]
704320617,1st5d,6,3,1,5,1,11769,[],[]
198004487,ThomRog1621,4,0,0,4,0,3191,[],[]
1229427349185273856,WokeTemple,50,3,9,41,3,33619,[],[]
867856606846894080,BaghdadBobCzar,0,0,0,0,0,1883,[],[]
609124089,308Eric,2,0,0,2,0,663,[],[]
181080454,SagDecWho,2,0,1,1,0,5593,[],[]
52819476,sooffy,0,0,0,0,0,74,[],[]
1072714907462844416,hipowermutant,0,0,0,0,0,372,[],[]
1081279924449804288,DocOfTheWild,2,0,0,2,0,21,[],[]
480135960,DanDeBusschere,15,6,4,11,0,191,[],[]
531840255,peggiarnold,0,0,0,0,0,1051,[],[]
1318566474689269762,stupidones2,0,0,0,0,0,4,[],[]
546234235,abakerink,5,0,0,5,0,805,[],[]
1332535251520937987,PhillipSYarbro2,0,0,0,0,0,0,[],[]
33634814,NoDogmaNoDogma,0,0,0,0,0,1139,[],[]
1311796161116807170,Gryffin_Logic,17,1,3,14,0,577,[],[]
1422210720,SilverDollar48,0,0,0,0,0,88,[],[]
1256441830322954242,VIVELERSISTANC1,7,0,2,5,0,3506,[],[]
256315692,trainermike111,1,0,0,1,0,261,[],[]
17523808,lisamightydavis,13,0,0,13,0,13211,[],[]
1308567930129403904,MikeCar16075968,0,0,0,0,0,0,[],[]
23921418,jeffsetlife,2,0,1,1,0,77,[],[]
1347960594,Kellyjean1020,0,0,0,0,0,84,[],[]
350045415,rogergumley,0,0,0,0,0,3688,[],[]
885800543897223168,SCAN_Monitor,0,0,0,0,0,175,[],[]
4710708974,christianllamar,2141,61,451,1690,59,67257,[],[]
2698389224,BrianMoulton1,0,0,0,0,0,13,[],[]
1243278447511769103,jdrichmond2020,5,0,2,3,0,3475,[],[]
755849496299380736,PeterGordon7117,4,1,0,4,0,6366,[],[]
1281425501790392320,FMto100power,0,0,0,0,0,439,[],[]
607730637,mom4boysHS,1,0,0,1,0,1409,[],[]
1324421292838322176,PetrinoJessica,0,0,0,0,0,20,[],[]
954182941701234691,TheTaxman24,0,0,0,0,0,9,[],[]
465194900,jogalukasjoao,1,1,0,1,0,23,[],[]
233041306,jmulk77,0,0,0,0,0,89,[],[]
82915738,UncleBarth,0,0,0,0,0,294,[],[]
47948354,Nanjimo,0,0,0,0,0,103,[],[]
3983296349,LakeMichFrau,1,0,0,1,0,847,[],[]
1332653788629520385,JohnMcn10558322,0,0,0,0,0,179,[],[]
1250143488118685697,huwglewis,1,0,0,1,0,190,[],[]
466113995,lfidelius,0,0,0,0,0,277,[],[]
960728432110784512,boiseoutspoken,2,0,1,1,0,3236,[],[]
1249361186543542272,Notafra67689516,0,0,0,0,0,847,[],[]
534725099,MikeStuhr,0,0,0,0,0,960,[],[]
1011008340367953920,wil_da_beast630,33,21,1,32,0,56686,[],[]
935446632,sanduchi133,6,1,0,6,1,3756,[],[]
1331054485121056768,ReulbachJ,0,0,0,0,0,675,[],[]
107445286,NWO_Watcher,24,0,2,22,1,3301,[],[]
1444313197,scout_nj,3,0,1,2,0,2943,[],[]
203188533,mhboone1,1,0,0,1,0,72,[],[]
8870522,FedCURE,0,0,0,0,0,547,[],[]
266051405,beavmyster,1,1,0,1,0,23,[],[]
782380023281881088,nanciivi,0,0,0,0,0,1,[],[]
57528178,debhernandez,0,0,0,0,0,2693,[],[]
254854424,Wilson10lax,0,0,0,0,0,1633,[],[]
312958261,Rev_Estes,0,0,0,0,0,596,[],[]
107641860,PieMonster777,0,0,0,0,0,189,[],[]
840333730183036929,kimulitamann1,0,0,0,0,0,22,[],[]
1298372091507617792,MonikaRhodes20,0,0,0,0,0,271,[],[]
1326998320309538816,blurred_musing,0,0,0,0,0,75,[],[]
1257413792104931333,NiedermeyerRush,6,2,3,3,0,83,[],[]
3417602621,Prof_Strontius,2,0,0,2,0,1041,[],[]
452085014,wynsome_gwen,1,1,1,0,0,1353,[],[]
27782837,McJesse,269,60,5,264,0,1132500,[],[]
49102516,jimmylemons,1,0,0,1,0,8941,[],[]
764928305858568192,HaroldSnepsts1,8,2,2,6,2,404,[],[]
202366356,billybsea,0,0,0,0,0,1362,[],[]
1323308574429372416,SandiHansen19,1,0,0,1,0,25,[],[]
1213871558839586816,HumanitiesData,2,1,0,2,0,1244,[],[]
1155127596914565120,khb312,0,0,0,0,0,79,[],[]
722643740,BrianLoweWriter,2,0,0,2,0,779,[],[]
1046951739797123072,nat_petrone85,1,0,0,1,0,104,[],[]
1724104855,iamsamjfox,1,0,0,1,0,452,[],[]
1069820899,JarrinJackson,8,0,3,5,0,6686,[],[]
880656157500723200,dbergen_103,0,0,0,0,0,20,[],[]
213945941,Abenaa46,0,0,0,0,0,1007,[],[]
1295704591753936901,DellHopkins2,1,0,0,1,0,339,[],[]
2381036899,AutismGrldCheez,0,0,0,0,0,2854,[],[]
1167949105160736768,MattJon90824543,1,0,0,1,0,960,[],[]
1210335578736209921,SamAdamsPatrio1,0,0,0,0,0,603,[],[]
1325519934,ChuckSoltys,96,5,15,81,6,6630,[],[]
1295422799973175297,GuyPlusBeard1,5,0,0,5,0,765,[],[]
3054348589,MCERLAlN,0,0,0,0,0,109,[],[]
859479493282590723,thefayster1957,0,1,0,0,0,1101,[],[]
705092016087154689,WFarr32016,0,0,0,0,0,10,[],[]
860291474189168640,lpohutsky19,283,2,42,241,13,19671,[],[]
1143251949460045829,BifrostRide,2,0,0,2,0,268,[],[]
1307875545171062785,DollPariah,0,0,0,0,0,1250,[],[]
20704522,jitenpatel,0,0,0,0,0,2025,[],[]
945411865051615233,joeshetina,5,0,0,5,0,123,[],[]
1334011312700010496,JudithBasile6,0,0,0,0,0,57,[],[]
805064950490300417,JohnsonCathline,0,0,0,0,0,20,[],[]
1192551633403752450,KentPpc,1,0,0,1,0,209,[],[]
16873644,sbkaye,0,0,0,0,0,512,[],[]
337229182,willraw24,0,0,0,0,0,31,[],[]
819082291766927360,cloudsuferdude,2,1,1,1,0,7,[],[]
3419237805,BobNotfondajane,1,0,0,1,0,3196,[],[]
1170432259,HalMarshall2309,4,1,1,3,0,2162,[],[]
31460146,MsAccountabilit,0,0,0,0,0,1803,[],[]
1296487661146902528,CrissyWow,1,0,0,1,0,90,[],[]
75332276,KevinBrashear,2,0,0,2,0,404,[],[]
1239770003051773952,charles93623749,0,0,0,0,0,288,[],[]
36182054,kandiamo,0,0,0,0,0,1,[],[]
1295907201081466880,roberte72807737,0,0,0,0,0,0,[],[]
548820109,rabin_michael,0,0,0,0,0,2,[],[]
202303356,drewberquist,22,1,3,19,0,12113,[],[]
774097036614393858,_SoccerThoughts,1,0,0,1,0,741,[],[]
1311282337683038209,1776inSC,1,0,0,1,0,698,[],[]
593296499,ParkeCarson,0,0,0,0,0,1650,[],[]
1089890655504089089,DavidHa15394275,0,0,0,0,0,77,[],[]
154021559,decodurval,0,0,0,0,0,1596,[],[]
1334323911283105795,LettusPray4Ever,0,0,0,0,0,7,[],[]
817045037817204736,danmcwilliams62,0,0,0,0,0,5,[],[]
824068316935421952,Aflame4Truth,1,0,0,1,0,974,[],[]
860556044,missourigirl732,0,0,0,0,0,26,[],[]
11782232,NewHampshireBen,5,4,0,5,0,11785,[],[]
933352705489276931,Ted92057448,1,0,0,1,0,1012,[],[]
875354179459588096,mandyjmali,0,0,0,0,0,65,[],[]
894965229892902913,AnonSource_1,0,0,0,0,0,39,[],[]
1144727766635409409,GarySim80882502,0,1,0,0,0,27,[],[]
1317033883,paulerockalot,3,0,0,3,0,1031,[],[]
22236071,santafeez,6,0,0,6,0,18627,[],[]
57512099,coachrex,3,0,0,3,0,470,[],[]
55081186,Toobaditstaken,1,0,0,1,0,607,[],[]
1202652623133765632,therant365,0,0,0,0,0,23,[],[]
880417607865815040,bttr_as1,33,0,7,26,0,10193,[],[]
1145856164401336321,CosmicallyF,0,0,0,0,0,680,[],[]
1267984619368075270,pcisbs1,1,1,0,1,0,5532,[],[]
1323363032806772736,girlmom007,1,1,0,1,0,134,[],[]
37295817,codyclarke,5,0,0,5,0,1866,[],[]
3343085200,justshootme_plz,0,0,0,0,0,3047,[],[]
15715289,RockyRd_Patriot,3,3,0,3,2,3477,[],[]
946432894997688320,al_Turkamani,17,1,1,16,0,2254,[],[]
3217430954,bulldogsandson,0,0,0,0,0,19,[],[]
826551399982850048,Marechtare1,13,1,3,10,0,8853,[],[]
780603207135277056,DawnMeyer1958,0,1,0,0,0,10,[],[]
715524288128921600,turbopaule,1,0,0,1,0,247,[],[]
1022428176,brlowder69,2,0,0,2,0,6440,[],[]
1231218603321647104,CompletelyUp,15,1,2,13,2,4332,[],[]
1257772243985272835,Bx1Judy,0,0,0,0,0,83,[],[]
2209431299,mrstraderjoe,2,0,0,2,0,189,[],[]
785993155351019520,bentsally11,1,0,1,0,0,802,[],[]
731894507994775552,bentleysally133,2,0,2,0,0,2582,[],[]
1046554048806105088,DirtGibbo,0,0,0,0,0,197,[],[]
798730178490986496,Lucero6Ray,0,0,0,0,0,21,[],[]
727150972712181761,ronniedeg,0,0,0,0,0,32,[],[]
2262702688,abeIrry,0,0,0,0,0,4760,[],[]
39553187,SLGBklyn,3,0,1,2,1,80,[],[]
1048718481368260608,Matt25921765,0,1,0,0,0,826,[],[]
109137637,truthwatcher,0,0,0,0,0,56,[],[]
2932776766,MSABbound,0,0,0,0,0,17,[],[]
536454357,dgtripp,0,0,0,0,0,0,[],[]
737869308,13Firecracker13,1,0,0,1,0,748,[],[]
38600703,forumdustin,1,0,0,1,0,438,[],[]
14701185,insighthr,0,0,0,0,0,121,[],[]
1270391476355203074,welder_rick,0,0,0,0,0,138,[],[]
4662992666,Rinkytone,0,1,0,0,0,1524,[],[]
1278371452077531136,SparrowHeart23,45,12,4,41,1,5016,[],[]
601259680,esmequesme,2,0,0,2,0,247,[],[]
239098915,mattletiss7,3259,672,299,2960,204,581102,[],[]
1278081826385547265,ReallyNotSad,0,0,0,0,0,1693,[],[]
1282399239532765184,F105Fighterjock,2,1,0,2,0,1,[],[]
1238254117665071104,DistractedAnna,32,2,1,31,0,4575,[],[]
19923848,realvictorad,0,0,0,0,0,1287,[],[]
1611699649,Colette4Cruz,1,0,0,1,0,3816,[],[]
926927411916230674,tyler_wb,0,0,0,0,0,706,[],[]
1325704256926707712,MagnusCalais,0,0,0,0,0,16,[],[]
1296531238052921344,BartlingMrs,0,0,0,0,0,2,[],[]
17693294,ViviATX,0,0,0,0,0,1704,[],[]
1321858306906988544,polialertcom,1,0,0,1,0,4736,[],[]
53979469,ramzpaul,783,71,37,746,20,69578,[],[]
478393119,TimB0626,0,1,0,0,0,142,[],[]
15869650,Jonf728,0,0,0,0,0,260,[],[]
578303951,JonMageeauthor,0,0,0,0,0,6243,[],[]
926653306717446145,YepDemocracy,0,0,0,0,0,7850,[],[]
37343086,marla_j98,1,0,0,1,0,6477,[],[]
2992113289,stephens_pt,0,0,0,0,0,1741,[],[]
333039751,LouisaCornell,2,0,0,2,0,1643,[],[]
1225570859659689993,DelrayRobbie,0,0,0,0,0,1763,[],[]
885578984368594944,nbrew73,1,0,0,1,0,4768,[],[]
24541387,cawilliamson,6,0,2,4,0,1582,[],[]
938419800921001987,I__BORG,3,0,0,3,0,511,[],[]
971898792185335808,SeanAnon82,0,0,0,0,0,2003,[],[]
728197957388881920,DmactotheD,2,0,0,2,0,138,[],[]
3058894086,IjuakosXqwzts,0,0,0,0,0,626,[],[]
2350533762,AndrewBVocalMan,0,0,0,0,0,319,[],[]
1291257183758254081,conspiracymill,7,0,4,3,1,3189,[],[]
1234479579030405122,VoteReason2020,0,0,0,0,0,27,[],[]
91255577,AndyinJapan,0,0,0,0,0,6,[],[]
97941710,karlautterback,1,0,0,1,0,25,[],[]
1270631077275742208,ExposeNeocons,0,0,0,0,0,46,[],[]
1101530855632195586,LafayetteLate,3,0,1,2,0,11,[],[]
82461263,zephyryne,0,0,0,0,0,833,[],[]
64088983,nd168,0,0,0,0,0,167,[],[]
495962767,tomcoolboy6789,3,1,0,3,0,169,[],[]
21791956,rromona,0,0,0,0,0,6865,[],[]
806059502,dizzyd2610,0,0,0,0,0,623,[],[]
1194031427358212096,MarathonofFact,0,0,0,0,0,206,[],[]
1299432677385408512,HeadOpinionated,1,0,0,1,0,4,[],[]
867912894490361856,aljones1818,1,0,0,1,0,18,[],[]
542965880,RispaFrances,3,0,1,2,0,657,[],[]
862980542,BenjiNdolo,15,6,0,15,1,111950,[],[]
22000269,ManilaChan,200,8,48,152,8,8301,[],[]
