User ID,User Name,Node_weight,Reply Count,Retweet count,Like Count,Quote Count,Followers Count,FOllowerID,Follower name
839908961876869120,CreepyJTroll,3,0,0,3,0,157,[],[]
1303537540553728000,terrorist_trump,0,1,0,0,0,419,[],[]
1183954801559658496,TresFort1,0,0,0,0,0,1126,[],[]
258428863,RegularKyleD,1,0,0,1,0,314,[],[]
1156360727118192640,DianeSaumure,1,0,0,1,0,933,[],[]
42449777,davehoy99,22,3,9,13,0,679,[],[]
166248297,TruthCopy,2,0,1,1,1,334,[],[]
824306046671851520,brendaworkshard,3,0,1,2,0,58,[],[]
336049934,psalm82,1,0,0,1,0,2089,[],[]
1022501659778400256,BodendorfJ,0,0,0,0,0,66,[],[]
885283952587624448,LiaGage2,0,0,0,0,0,2283,[],[]
1174396862888960000,QuackenRelease,7,0,2,5,0,4929,[],[]
16106584,stillgray,4759,2972,541,4218,555,311447,[],[]
2880052887,trom771,15156,412,5172,9984,766,65374,[],[]
15382897,jpkm_,0,1,0,0,0,424,[],[]
620598708,rustedtraveler,3,0,0,3,0,1209,[],[]
1110380174326009856,miguelmike49,0,0,0,0,0,186,[],[]
526764151,newworldtweeter,1,0,0,1,0,432,[],[]
31749701,CarrKicksDoor,1,1,0,1,0,146,[],[]
1069617357289598976,algo_capital,5,0,1,4,0,167,[],[]
2868370994,Suzi3D,96,7,20,76,0,30370,[],[]
264556253,DianaRVA1,1,0,0,1,0,2343,[],[]
1337095387342106639,Mexacali_Rose,0,0,0,0,0,87,[],[]
781997033460789248,FTT_Pat,0,1,0,0,0,614,[],[]
965304316125962240,fail92,0,0,0,0,0,384,[],[]
58245058,TraceySchulz,1,0,0,1,0,1545,[],[]
2285915503,grissom1322,0,0,0,0,0,55,[],[]
2671008314,glenlg2,16,1,2,14,0,14498,[],[]
1332737886253424641,JakeDiamondbac1,1,1,0,1,0,4147,[],[]
2202352694,wuensche_robin,0,0,0,0,0,6,[],[]
32982195,FlossObama,663,50,135,528,18,26193,[],[]
732223669,godmother_nanny,2,1,0,2,0,5160,[],[]
384997325,MonicaPerezShow,25,2,5,20,0,17012,[],[]
2516897990,AdvanceHumanism,11,0,4,7,0,8243,[],[]
289664584,CamABlack,1,1,0,1,0,571,[],[]
717398291571412992,TruePerspicuity,0,0,0,0,0,1371,[],[]
607387125,Katybugs,0,0,0,0,0,16,[],[]
390776477,emmyxo1,0,1,0,0,0,1031,[],[]
39308373,mattklapper,131,4,26,105,1,15615,[],[]
824514788432744448,TammeraWright5,1,0,0,1,0,134,[],[]
281744819,dalehenrygeist,0,0,0,0,0,1546,[],[]
788560161824575488,SeeingEyeAgency,0,1,0,0,0,290,[],[]
3307060124,StopTheCoup2020,3,1,2,1,0,3088,[],[]
399078204,Redlegs1111,3,2,0,3,1,373,[],[]
1322719154806415362,Gina26287062,0,0,0,0,0,918,[],[]
1330842926335860736,PGKracken,7,0,2,5,0,800,[],[]
1252570692186505216,userdeebee,7,1,0,7,0,1816,[],[]
1245723368499941378,Patrici89587380,0,0,0,0,0,86,[],[]
565099885,DamariusH,0,0,0,0,0,300,[],[]
630830085,dswarbrick97,2,0,0,2,0,445,[],[]
1302467703035375618,ljacquetsr,0,0,0,0,0,2,[],[]
347568283,nourapen,1,0,0,1,0,187,[],[]
1248854980666085376,LeverSmash,30,1,3,27,0,1058,[],[]
1185205275810246656,skye_gary,5,0,1,4,0,24177,[],[]
2243152274,jermergerg,0,0,0,0,0,216,[],[]
1285775233136418817,Chrissy03316300,0,0,0,0,0,1,[],[]
31331079,jstevh,0,0,0,0,0,204,[],[]
397771451,LauraVanOversch,3,0,1,2,0,2954,[],[]
2175805708,R0denDean,0,0,0,0,0,311,[],[]
1045725697086492672,wildelk68,0,1,0,0,0,7,[],[]
121164126,BrianRoastbeef,0,1,0,0,0,125,[],[]
798917467330514944,ibrahim_201777,0,0,0,0,0,557,[],[]
219141142,SawyerHackett,2362,47,566,1796,24,46037,[],[]
886276370787168256,MisterPimUSA,1,0,0,1,0,87,[],[]
1079847395553411072,Yborcity55,0,0,0,0,0,22,[],[]
978416274157068288,RiskyClay,2,1,0,2,0,103,[],[]
1262175711630155776,B4UGO17,0,0,0,0,0,60,[],[]
245077291,JordanPlain,2,0,1,1,0,2545,[],[]
958706821,AuroraBirdialis,3,0,0,3,0,1256,[],[]
72759805,UniquelyJustine,0,0,0,0,0,497,[],[]
632391556,timiversen8,6,17,1,5,3,49,[],[]
993289058314014720,ScottImmordino,52,8,18,34,1,20425,[],[]
1187843566065934341,TomTomashek,0,0,0,0,0,41,[],[]
51698123,RiadhAlsindy,0,0,0,0,0,48,[],[]
929079780,JustTRUMPem,0,0,0,0,0,352,[],[]
1329795912630226950,EffffBrandon,1,0,0,1,0,48,[],[]
608512987,StanleyCohenLaw,472,35,81,391,14,40026,[],[]
1541985373,akight78,0,0,0,0,0,861,[],[]
1300515858930905103,NoLuv4UDrJones,0,0,0,0,0,40,[],[]
1929780564,lew1301,0,0,0,0,0,8,[],[]
12363792,jonbecker,3,1,0,3,0,12246,[],[]
372518997,jpfox,1,0,0,1,0,2809,[],[]
1097103256000417792,CricCrazyRoyal,2,0,1,1,0,14,[],[]
45511031,jd_durkin,45,0,9,36,7,29251,[],[]
23991082,srajaramster,0,0,0,0,0,60,[],[]
179645471,legendoflumis,1,0,0,1,0,83,[],[]
3193024161,OpinionatedNana,0,0,0,0,0,477,[],[]
3196729878,theRealFreese,0,3,0,0,0,59,[],[]
250226766,CorporateShake,0,0,0,0,0,30,[],[]
1954384994,Principalaz,0,1,0,0,0,2216,[],[]
15360184,tedstew,1,0,0,1,0,5924,[],[]
31275412,tvisgreat,9,1,0,9,0,1115,[],[]
86403191,falconnestorg,1,0,0,1,0,877,[],[]
2796614299,_AustinLandis,10,3,4,6,0,2839,[],[]
21252618,JakeSherman,3603,1414,700,2903,979,350680,[],[]
14597239,TonyRomm,3,1,0,3,1,36564,[],[]
1004458652256882688,Live_News_Nick,0,0,0,0,0,4094,[],[]
1084906422331158528,Forexmkts,0,0,0,0,0,1815,[],[]
266082837,4xInsight,5,0,0,5,0,26569,[],[]
381696140,Financialjuice1,6,1,1,5,0,144266,[],[]
1219899283,MrChew3131,0,0,0,0,0,866,[],[]
407013776,burgessev,309,68,86,223,67,132657,[],[]
1256637673055203329,WarwitEveryone,0,0,0,0,0,90,[],[]
983736940448112640,AgueroForTexas,18,3,6,12,0,5603,[],[]
82265926,FACEITDuran,1,1,0,1,0,1228,[],[]
43155913,beckieskitchen,0,0,0,0,0,5128,[],[]
1181763022227935233,JerradTieman,0,0,0,0,0,516,[],[]
19657069,freedomthistime,1,0,1,0,0,150,[],[]
1016622756,Dawn337Nelson,0,0,0,0,0,59,[],[]
150810789,Marvilicious01,0,0,0,0,0,1122,[],[]
1300832865655992320,pink_glue,0,0,0,0,0,6,[],[]
69360421,alanrycroft,0,0,0,0,0,1190,[],[]
1093254034214080512,HoodHealer,194,6,20,174,4,109671,[],[]
425312831,Grill_You,3,0,0,3,0,585,[],[]
405030453,nancydrew44,0,0,0,0,0,195,[],[]
2799540945,2mimik,0,0,0,0,0,60,[],[]
58647112,SpazzBhabie,0,1,0,0,0,788,[],[]
474552165,ScottAulde,0,0,0,0,0,8695,[],[]
800685640371142656,GHBrady_28,5,0,4,1,0,3143,[],[]
1335982385461125122,DanaBar15893607,0,0,0,0,0,57,[],[]
1336468181364432896,JackTard11,0,0,0,0,0,1,[],[]
1271444717314637824,colelassal,0,1,0,0,0,9,[],[]
154693224,GregoryDavidLLC,0,0,0,0,0,406,[],[]
1319857949993480192,the_cole_garvin,0,0,0,0,0,69,[],[]
926603734070599680,OrionGarrett,1,0,0,1,0,173,[],[]
37808851,TexBlue,0,0,0,0,0,2311,[],[]
2614659025,NotThatDull,0,0,0,0,0,13,[],[]
1109484596,jakerv97,2,0,0,2,0,288,[],[]
782653361237561345,Rufree13,0,0,0,0,0,31,[],[]
1341420376983805952,LibertyNole,0,0,0,0,0,22,[],[]
1205867395,lklfaith,118,44,29,89,7,6038,[],[]
363778131,kmindeye,12,0,3,9,0,2486,[],[]
782145443551510528,coach___walker,8,2,2,6,2,3939,[],[]
1319002289848217600,o2b12087221,0,0,0,0,0,3,[],[]
456541283,eaglesoft1980,0,0,0,0,0,418,[],[]
960624440,BrettGilbertTV,2,1,0,2,0,303,[],[]
4163378603,c_tiot,374,26,59,315,13,11965,[],[]
17231100,lou_nautic,30,9,2,28,0,1904,[],[]
384435212,JackMelim,0,0,0,0,0,17,[],[]
961149942516592640,nattydugong,1,1,0,1,0,34,[],[]
237595560,MelLovesLife1,0,0,0,0,0,183,[],[]
755465826,sprintquinn6,0,0,0,0,0,71,[],[]
49401951,Grifiki,0,0,0,0,0,16,[],[]
1339325072604065794,PeoplesPatriot_,0,0,0,0,0,26,[],[]
1079417203651461121,Bill36621109,1,0,0,1,0,138,[],[]
909234955,reshmatrasi,1,0,0,1,0,820,[],[]
2903108133,JohnBoudreaux4,0,0,0,0,0,8,[],[]
734055560505491456,IntrigueVerse,1,0,0,1,0,4426,[],[]
971055182653067265,TrevaCONeil1,0,0,0,0,0,0,[],[]
16192261,_kimrandall,6,0,0,6,0,21830,[],[]
30535995,BryanHefner,0,0,0,0,0,250,[],[]
3945761183,WatsaMatterU,0,0,0,0,0,3,[],[]
2942092599,RickCohenkatz,0,1,0,0,0,0,[],[]
1242534125321334784,CatheriGreat,1,0,0,1,0,1887,[],[]
1332417368254013441,vetsnjets,0,0,0,0,0,1,[],[]
1100568968035737600,AlanMcArthur13,0,0,0,0,0,67,[],[]
863361660,JFulleman,0,0,0,0,0,407,[],[]
714704686784323585,vice_v_vogue,0,0,0,0,0,57,[],[]
1115280192128331777,Mr_Decrypto,0,0,0,0,0,651,[],[]
519582908,DavidAlanCoia,0,0,0,0,0,4472,[],[]
1298976858004889601,Megachirella,0,1,0,0,0,32,[],[]
1322544708204322817,David76538603,0,0,0,0,0,22,[],[]
966730117488762880,jabednarcik,0,0,0,0,0,1,[],[]
497471097,DoubleBee21,0,0,0,0,0,419,[],[]
96975818,gregtmorin,8,2,1,7,0,1044,[],[]
69091279,fnihost,1,1,0,1,0,358,[],[]
47224965,SelenicMagick,1,0,0,1,0,1364,[],[]
1326986703744217092,EvansEmber,1,0,0,1,0,7,[],[]
1132978314,TriCitiesChess,0,1,0,0,0,5,[],[]
870103924207910912,gwells43,2,2,2,0,1,295,[],[]
1341781322809929729,disruptivintent,0,0,0,0,0,7,[],[]
37341000,illusory_tenant,2,2,0,2,0,3195,[],[]
1134398159319420928,SweatNewton,0,0,0,0,0,0,[],[]
1191057450897686529,thepatriot66,1,0,0,1,0,2438,[],[]
1311091451913277446,pnda8818,0,0,0,0,0,0,[],[]
1221608794486165506,AdayGeron,0,0,0,0,0,1142,[],[]
1321472530763321344,CindyWeingate,0,0,0,0,0,125,[],[]
263841004,GeriConwa,0,0,0,0,0,123,[],[]
797970505621901312,KathrynTomashu1,3,2,0,3,0,5929,[],[]
1040635209513926656,mecarolynneEJ,0,0,0,0,0,0,[],[]
948213198,BrendaRefshaw,33,5,5,28,3,3961,[],[]
40014359,KRIMSONRANE,1,0,0,1,0,49,[],[]
2247650148,NoxFox814,1,0,0,1,0,231,[],[]
347009187,blancayjohn,1,1,0,1,0,474,[],[]
2721878202,ericrnolan1,3,1,0,3,0,1454,[],[]
2582330862,ChrisNipe,5,2,0,5,0,225,[],[]
1202267602124509185,Jkinney01295787,1,0,0,1,0,6,[],[]
2855440393,onlyascing,47,2,11,36,4,10599,[],[]
155986770,joylynbest,9,1,4,5,0,10740,[],[]
1337377346865795074,CapNBob7,1,0,0,1,0,0,[],[]
1187754490474192896,BoarGator,26,3,4,22,1,3134,[],[]
3163862072,CaduceusLucrum,0,0,0,0,0,214,[],[]
1863087948,Snapitson,8,1,1,7,0,2989,[],[]
1003084416,krissy4872,1,0,0,1,0,236,[],[]
802876925827956736,RobbersonJon,302,25,97,205,14,24773,[],[]
1297882101119844353,Larry01512231,0,0,0,0,0,0,[],[]
17984687,Resisting_Rebel,0,0,0,0,0,5755,[],[]
1648786711,BeckyRicker638,1,0,0,1,0,726,[],[]
384940947,OOSA_Homeless,0,0,0,0,0,42,[],[]
2690848557,s_titoe,1,0,0,1,0,286,[],[]
789373106641133568,DeenaG33,0,1,0,0,0,82,[],[]
2283817142,noahcd28,0,0,0,0,0,134,[],[]
1330075163413663745,AliAli62169696,8,0,6,2,0,89,[],[]
3246263245,mark_gowings,5,0,0,5,0,1127,[],[]
17995774,sguggenheim,0,0,0,0,0,3056,[],[]
851250121639682048,realCamachoPrez,0,0,0,0,0,12,[],[]
427921310,okiebadokie,0,0,0,0,0,165,[],[]
1577460584,dmdennis68,0,0,0,0,0,1119,[],[]
954185743034978305,dogpoopelosi1,2,0,1,1,0,4943,[],[]
1121480893585973249,Artien12,0,0,0,0,0,2,[],[]
822521124298833920,willdickham,1,0,0,1,0,2055,[],[]
222387441,Jam1p,0,0,0,0,0,7502,[],[]
1026392407120609280,cazzinating,2,0,0,2,0,21,[],[]
1273194346834087936,zorrothewonder1,4,1,1,3,2,1582,[],[]
298073560,JeanCLoftus,1,0,0,1,0,153,[],[]
71688860,CLEPTOKRACIA,0,0,0,0,0,694,[],[]
748688182242312192,HeleneC20,0,1,0,0,0,384,[],[]
756120069181026304,Kaskinlive,0,0,0,0,0,553,[],[]
15790644,SueDinNY,27,2,9,18,2,4083,[],[]
1080636859116601344,StarsCountdown,5,0,0,5,0,699,[],[]
2227286316,MayforTexas,2,0,1,1,0,193,[],[]
247752491,theistinthought,27,3,2,25,0,2469,[],[]
63619380,Roseep00h,0,0,0,0,0,177,[],[]
4840456839,RhondaGiannell1,5,0,2,3,1,3192,[],[]
716846286679515136,Lacolealex,1,1,1,0,0,27,[],[]
887259984,TheRealFixNow,0,0,0,0,0,4331,[],[]
25753428,dom_erella,1,1,0,1,0,1201,[],[]
2393339876,DaMihi_Libertas,0,0,0,0,0,369,[],[]
909886850302652416,LLAZYWEATHER,0,1,0,0,0,59,[],[]
32913137,drsammyj,0,0,0,0,0,173,[],[]
710905609,Sapphire_Sky11,4,1,3,1,0,233,[],[]
16672644,pjhnsn8,6,0,2,4,0,3378,[],[]
3488386578,fuzzypawlz,0,2,0,0,0,102,[],[]
1321625788777590785,fb_senem,0,0,0,0,0,3,[],[]
815493158,KingdomUseful,1,0,0,1,0,13423,[],[]
32122881,Le_Crawf,1,1,0,1,0,2290,[],[]
1309303115850674176,JayAbshier,0,0,0,0,0,402,[],[]
71855042,malcolmvenable,13,3,0,13,0,2014,[],[]
184421889,harishnangia,3,0,1,2,0,322,[],[]
1187465769778442240,WoodrowForCO,132,10,6,126,3,11541,[],[]
1215482418087563264,PeteBes75179470,0,0,0,0,0,1,[],[]
262365555,Gabino_Iglesias,146,11,5,141,2,29329,[],[]
803292343520505856,Lone_WolfSF,1,0,0,1,0,471,[],[]
40156515,SilverGirl64,0,0,0,0,0,112,[],[]
1338658276976758785,InezJor73736394,0,0,0,0,0,1,[],[]
54476900,brettfowkes,1,0,0,1,0,31,[],[]
480621462,AlBurley,0,0,0,0,0,93,[],[]
1341764042529116165,Aaron4Trump2020,0,0,0,0,0,31,[],[]
819300029814947851,RickOceanMusic,13,0,1,12,0,15491,[],[]
753722009910124544,Sasademon77,2,0,0,2,0,1514,[],[]
1325475564719845377,Azzking3,0,0,0,0,0,0,[],[]
101395252,jstines3,2,1,1,1,0,133007,[],[]
36198581,KEYaTO_HISHEART,0,0,0,0,0,1457,[],[]
996915029344706560,BlackHoleMind,0,0,0,0,0,419,[],[]
14893145,ausetkmt,3,0,1,2,0,3347,[],[]
206522003,rdj168,0,0,0,0,0,17,[],[]
1282425373045776384,EndgamePuncher,0,0,0,0,0,950,[],[]
1183192509578502144,may_talcott,268,60,170,98,27,7359,[],[]
864269682118938624,219Hoagie,1,0,0,1,0,692,[],[]
1239738223238303744,gene43772276,0,0,0,0,0,0,[],[]
15062569,MacGirlie,1,0,0,1,0,391,[],[]
1621785630,Weegduff,0,0,0,0,0,97,[],[]
1307866987570237440,KatieKatInAZ,0,0,0,0,0,2364,[],[]
2993479331,htcwaffle,0,0,0,0,0,149,[],[]
1213904604699561985,Marvin24838169,0,0,0,0,0,19,[],[]
4853925971,REDCO131,25,3,7,18,0,5868,[],[]
892093175883599875,JimJeffery11,0,0,0,0,0,122,[],[]
828348622697750528,BIGSEXYYT,7,1,1,6,0,6691,[],[]
35412973,kerbare00,2,2,0,2,0,64,[],[]
190436778,bbumpey,0,0,0,0,0,13,[],[]
2411964918,_smoke_14,1,0,0,1,0,44,[],[]
831983280484446212,Roberto79075927,0,0,0,0,0,315,[],[]
1136644288362627073,PatriotSeekin,0,0,0,0,0,1341,[],[]
1210753495525015552,whackman777,1,2,0,1,0,281,[],[]
115497418,M__Ortiz,2,0,0,2,0,2248,[],[]
23260313,SheilaGOP,2,0,0,2,0,988,[],[]
2667125713,LALiving213,0,0,0,0,0,1632,[],[]
599803422,recmar08,1,0,0,1,0,7673,[],[]
4872757378,GeorgeSkoulikas,0,0,0,0,0,906,[],[]
1192554760706113537,Crystal__Monroe,135,5,30,105,9,9440,[],[]
635637554,LTNYG123,0,0,0,0,0,5,[],[]
46132618,sjunkins,10,1,2,8,0,31203,[],[]
468760543,JusticeCaptain,6,0,1,5,0,74,[],[]
1147095410076315649,beceldora,0,1,0,0,0,173,[],[]
3912945200,ElportoPaul,0,0,0,0,0,108,[],[]
110763688,Hoozr,0,0,0,0,0,86,[],[]
2302226918,UsecommonSentz,1,1,0,1,0,300,[],[]
2793457138,KimMlander,0,0,0,0,0,116,[],[]
3252744720,wendyje37672459,0,0,0,0,0,2,[],[]
1185323879981633542,ma_hlove,0,0,0,0,0,354,[],[]
1339733673655099400,ithrient,0,0,0,0,0,0,[],[]
911712942063783941,HDBelmont,2,0,0,2,0,133,[],[]
1114006008899223553,Susan63283785,0,0,0,0,0,266,[],[]
1560758540,RaDadtouille,1,0,0,1,0,1791,[],[]
347346908,ItsEatingTime,2,0,0,2,0,112,[],[]
1182054559868321797,LindaWrights4TV,2,0,0,2,0,140,[],[]
152454089,YEHATerence,0,0,0,0,0,2,[],[]
213305818,jimgeeting,1,0,1,0,0,6927,[],[]
1174540341203980289,rafaelken1989,5,2,0,5,0,3387,[],[]
33936778,MikeZooLoo,3,0,0,3,0,460,[],[]
355945505,brett_7g,1,0,0,1,0,390,[],[]
915700432529268736,athenaspsyche,0,0,0,0,0,78,[],[]
1240102894810038272,shariba91287910,0,0,0,0,0,1,[],[]
519953759,Bryan_Hilycord,0,0,0,0,0,194,[],[]
192220504,RelevantThinker,0,0,0,0,0,352,[],[]
844728127,mrchrisemerson,0,0,0,0,0,117,[],[]
44109084,acriticalmass,0,0,0,0,0,473,[],[]
983061654442266624,andrewhallmi,0,0,0,0,0,47,[],[]
361613056,NRaborn,0,1,0,0,0,3,[],[]
18070567,latortuga78,0,1,0,0,0,806,[],[]
2369438167,nicole_backslee,0,0,0,0,0,88,[],[]
2177202680,HogriderKafir,0,0,0,0,0,756,[],[]
65057161,shawarmamayor,0,0,0,0,0,233,[],[]
1309401701070385153,shmueli2020,1,0,0,1,0,5,[],[]
770318310,ArtMurray1,1,0,0,1,0,181,[],[]
740383311420391424,HerschelHatrack,0,0,0,0,0,33,[],[]
1029410429670486016,Platos_iPad,1,0,0,1,0,189,[],[]
70197451,__carson,0,0,0,0,0,34,[],[]
2725166774,MicksIrishLassi,0,0,0,0,0,61,[],[]
923335493802131456,Mike75717002,0,0,0,0,0,2168,[],[]
24298337,happily_his_mrs,0,0,0,0,0,20,[],[]
977287298386710530,AwakeYoda,17,2,1,16,0,1550,[],[]
2459112931,ksummers96,0,0,0,0,0,471,[],[]
1328436358503936001,ArtistAJ17,13,2,3,10,0,20676,[],[]
948484658,steelmanfan07,1,1,0,1,0,1306,[],[]
2357482316,king_ritzdorf_2,1,0,0,1,0,90,[],[]
1314200498627645440,ChaimHirsch2,88,3,9,79,0,2222,[],[]
1011376082388488193,whorutwo,0,0,0,0,0,15,[],[]
1948210681,baker_bakefam5,0,0,0,0,0,299,[],[]
3010934280,SgtMonie1236,0,0,0,0,0,3126,[],[]
1262161647818457088,Bender_NLM,0,0,0,0,0,35,[],[]
855221857670152193,brian_hoeffling,0,1,0,0,0,178,[],[]
222589216,T_Haugh_13,1,0,0,1,0,1222,[],[]
604785353,chadabizeid,187,24,46,141,3,20562,[],[]
281323784,Loud_Clouds,0,0,0,0,0,406,[],[]
1341174908768940032,CMick98881209,0,0,0,0,0,0,[],[]
816955361483689985,williams124_t,0,0,0,0,0,1817,[],[]
800133557414871040,rebeccam70,1,0,0,1,0,110,[],[]
1182069961172238336,jcamarine3,0,0,0,0,0,307,[],[]
157075236,newsvandal,1,1,0,1,0,1600,[],[]
1053269337732190209,CoreyTrue1,0,0,0,0,0,16,[],[]
5571722,Wisco,8,1,3,5,0,5768,[],[]
4688602574,PhantoMantis,6,1,0,6,0,1588,[],[]
1328917261873188864,BeetaStreet,0,0,0,0,0,1,[],[]
1641437239,YGordon103,0,0,0,0,0,3,[],[]
1178422716623462405,connorj22296581,0,0,0,0,0,4,[],[]
1289365089729085446,bellbottomsrock,0,0,0,0,0,1413,[],[]
463455665,BrianJFranks,1,1,1,0,0,33,[],[]
574174660,BlackSabbath22,0,0,0,0,0,70,[],[]
1336854958725951490,NancyGo22432376,15,2,2,13,1,8760,[],[]
1277297819733426177,Delanostrickla8,1,1,0,1,0,0,[],[]
1326137105471434752,RobertA79890450,0,0,0,0,0,17,[],[]
816199476742230016,strollingrabbi,30,2,3,27,0,10193,[],[]
744451764062130176,openchatter,0,0,0,0,0,97,[],[]
1331260157343502349,YourMom72615468,0,0,0,0,0,2,[],[]
218795383,MLeeJohnson,0,0,0,0,0,2469,[],[]
1257333412853157888,ChildishBriton,0,0,0,0,0,124,[],[]
1296154082944655370,itsclobbintime,1,0,0,1,0,546,[],[]
111383010,RAS252330,8,0,2,6,0,921,[],[]
1609342910,garnmcgaughn,2,1,0,2,0,347,[],[]
1044030953226739718,Connor_is_lovly,5,2,0,5,0,1628,[],[]
1290397225374216192,MargowNV,0,0,0,0,0,1691,[],[]
977487676441092096,ugochalacha,13,1,1,12,0,92,[],[]
193085779,PsilentMajority,0,0,0,0,0,111,[],[]
770041633,CalebJuarez77,0,0,0,0,0,92,[],[]
1551593126,Cheesin1982,4,0,0,4,0,988,[],[]
986982171838730240,zackjp86,0,0,0,0,0,174,[],[]
245567280,vancemurphy,85,9,9,76,0,6003,[],[]
532158116,Jbutler9Jon,2,0,0,2,0,7037,[],[]
18634205,MacGregorGarlic,0,0,0,0,0,366,[],[]
1343670849245732865,MAGANOW7,0,0,0,0,0,0,[],[]
2391429342,wildflower1961,0,1,0,0,0,7510,[],[]
1149712529557458944,theanthonyfink,4,0,1,3,0,323,[],[]
1241715892184064000,DomGuerra22,6,0,2,4,0,1082,[],[]
713061530892427265,BADKIN5,0,0,0,0,0,333,[],[]
25166708,na_cotic,5,0,0,5,0,409,[],[]
340597105,unclebarry1,1,0,0,1,0,537,[],[]
1281317477167828993,Sensei571,0,0,0,0,0,19,[],[]
426358716,MkPaxson,8,1,0,8,0,429,[],[]
1337959111959273473,ClittyJones,0,1,0,0,0,276,[],[]
1325271511431745538,JSylvainhuret,0,0,0,0,0,0,[],[]
1238035861805109250,LuckyGI10,0,0,0,0,0,0,[],[]
1894778892,KaymacAZ,1,0,0,1,0,4281,[],[]
253141769,Novidames,1,0,0,1,0,39,[],[]
898170082680909825,KevinAbbugunzza,0,0,0,0,1,12,[],[]
120592197,J_TheCynic,3,1,0,3,0,1140,[],[]
56050598,The_Wolfshifter,1,1,0,1,0,1231,[],[]
1209613903233257472,RandySchrum,2,0,0,2,0,457,[],[]
1290605796733132800,MadYad6,0,0,0,0,0,4070,[],[]
3211098629,45_Undefeated,0,0,0,0,0,260,[],[]
14394358,Robert_B,0,0,0,0,0,298,[],[]
939642795693887490,anytaxistheft,0,0,0,0,0,3,[],[]
1179996954,ChadHansen9972,0,1,0,0,0,359,[],[]
16428036,firejack007,0,0,0,0,0,537,[],[]
803317963004645377,TruthChats,2,0,1,1,0,271,[],[]
757018499478728704,Zino_Phoebe,2,0,1,1,0,515,[],[]
3477531563,JamesCheef,36,11,4,32,2,9193,[],[]
55764205,LBRhoden,1,0,0,1,0,242,[],[]
967790429684027392,irah_chandler,0,0,0,0,0,88,[],[]
1343596301548720128,SyncopeHD,0,0,0,0,0,1,[],[]
22536187,wdelpilar,0,1,0,0,0,2506,[],[]
1341994849,zgolferlck,0,0,0,0,0,388,[],[]
2505435427,McGrewRey,0,0,0,0,0,349,[],[]
1207679587427192832,rickey_papa,0,0,0,0,0,278,[],[]
108033897,WordsmithWyle,0,0,0,0,0,690,[],[]
1279148455,PowerOf2Less1,0,0,0,0,1,3434,[],[]
22792642,almightydanish,5,1,1,4,0,1189,[],[]
42709201,Webb_Clay,14,0,0,14,0,1915,[],[]
1349755278,shahinM7070,0,0,0,0,0,399,[],[]
1204785299659866114,exposebeastsys,0,0,0,0,0,184,[],[]
470358690,litoa0,1,0,0,1,0,13,[],[]
1253337025945628673,exline_ken,7,0,1,6,0,7500,[],[]
733015641402155008,IbuguLlc,0,0,0,0,0,3589,[],[]
1279528806924025861,WeThePeop1eUSA,1,0,0,1,0,2755,[],[]
378029485,verytari,0,0,0,0,0,6486,[],[]
4456110995,trucker156811,1,1,0,1,0,1,[],[]
1964424463,DebDahl1,0,0,0,0,0,250,[],[]
818980053484584960,DJTchump,0,0,0,0,0,1157,[],[]
1161598341119168513,Paradoxnewsline,1,1,0,1,0,3415,[],[]
1338785794367004674,M112173,0,0,0,0,0,216,[],[]
936047459054358529,dailycircuspod,0,0,0,0,0,911,[],[]
821185208024236032,bigleaguebunny,0,0,0,0,0,40,[],[]
888415859638665218,pardonbot,0,0,0,0,0,11,[],[]
1331425942837866499,JohnCur35987420,0,0,0,0,0,41,[],[]
919603293239808000,LadyPieholeBot,0,0,0,0,0,10,[],[]
4720781838,jiml2714,0,0,0,0,0,17,[],[]
3588165255,Binarymap,0,0,0,0,0,1058,[],[]
1285242331831111681,APatriotist,0,0,0,0,0,437,[],[]
177986963,flaviodilorenzo,0,0,0,0,0,83,[],[]
2579526600,charalutes,0,0,0,0,0,119,[],[]
17308589,acvisionace,0,0,0,0,0,193,[],[]
796811192924770305,UnfollowTrump,49,81,3,46,9,120697,[],[]
1300173916577513472,rix1475,0,0,0,0,0,1714,[],[]
14544622,rhondawhaley,0,0,0,0,0,523,[],[]
974961399045722112,MarteInga,0,0,0,0,0,18,[],[]
1303052358038020099,theivanka2024,0,0,0,0,0,1152,[],[]
841704342474375170,POTUSPreserved,0,0,0,0,0,68,[],[]
1259968241193148417,eval_prime,0,0,0,0,0,20,[],[]
1016378328,ShannonMentges,0,0,0,0,0,18,[],[]
1234704684411228160,GatekprrDavid,1,1,0,1,1,125,[],[]
1269174562165387264,JeffSco53188471,0,0,0,0,0,13,[],[]
1192605503865659392,sombra__tw,1,0,0,1,0,1203,[],[]
1682435060,CanipeBrent,0,0,0,0,0,239,[],[]
777986858429083648,Emerald_breezes,0,0,0,0,0,8,[],[]
1085580922349649921,BakerStevenJA1,0,0,0,0,0,2,[],[]
705517822214930432,3chent,0,0,0,0,0,4,[],[]
1243723887918993409,WilliamChagoll2,0,0,0,0,0,60,[],[]
1312546708212125697,Joesyourface,0,0,0,0,0,0,[],[]
1284059548286844929,Echo1roger,0,0,0,0,0,28,[],[]
17180761,ybarrap,157,9,44,113,3,25233,[],[]
2479989081,momofarmympvet,40,6,16,24,0,17195,[],[]
812179839159443456,Trummmp,0,0,0,0,0,12,[],[]
1151558903303462912,Carlos39631188,0,0,0,0,0,2,[],[]
109621134,Spinn360,0,0,0,0,0,63,[],[]
430118889,imx007,9,0,2,7,0,16301,[],[]
739321328143093760,JordanRoux6,0,0,0,0,0,12,[],[]
25178656,sranalli,2,0,1,1,0,282,[],[]
821055486539665409,ShitTrumpTweets,1,0,0,1,0,157,[],[]
1331111824440385536,womenforthecon,1,0,0,1,0,37,[],[]
25939051,jazer313,0,0,0,0,0,33,[],[]
1049292203707830272,HellerJagna,1,0,0,1,0,1043,[],[]
271480537,Cinemaslap,0,0,0,0,0,44,[],[]
703777029762600961,LetGetPolitical,0,0,0,0,0,3,[],[]
74435840,Giapet3,0,0,0,0,0,1283,[],[]
4341540975,BruceFutur1,0,0,0,0,0,209,[],[]
1592223612,beyda_rachel,0,1,0,0,0,14,[],[]
43588936,007__NIL,3,0,0,3,0,11867,[],[]
10085312,JPDaltonAZ,0,1,0,0,0,1767,[],[]
818948638890217473,RepMattGaetz,92224,6027,13937,78287,2111,1494389,[],[]
11615682,SperoNews,0,0,0,0,0,757,[],[]
762361257718484992,DairyFreeLemon,0,0,0,0,0,80,[],[]
1324495675237847040,dlocal56,0,0,0,0,0,1,[],[]
279243645,GraceStrength,0,0,0,0,0,539,[],[]
1341832603771543552,red_auntie,1,1,0,1,0,439,[],[]
1035115242,sweepnwin,25,1,4,21,1,3417,[],[]
126011734,daylelynndavis,0,0,0,0,0,47,[],[]
775853550849011712,braedenth,0,0,0,0,0,86,[],[]
1263563795370311682,Johnnybravo2032,0,0,0,0,0,0,[],[]
1018390514,JenZatoth1,1,1,1,0,0,295,[],[]
1204930164389556224,DoniTheDon_,1406,73,175,1231,25,48510,[],[]
1886570892,tturner0113,0,1,0,0,0,2,[],[]
1250686176,jordanbutwithay,1,0,0,1,0,384,[],[]
362708080,DMRHerbs,21,1,2,19,0,36803,[],[]
1321249999947210752,v_robinette,0,1,0,0,0,3,[],[]
879504146583375873,WaltDipsey,0,0,0,0,0,19,[],[]
383523180,JustJolene20,35,0,19,16,1,5397,[],[]
1227673641229389829,duganfife38,1,0,0,1,0,1835,[],[]
556484999,Sig_Otter,0,0,0,0,0,692,[],[]
1284249577550487552,antiLiberalism7,526,31,190,336,27,478,[],[]
826435842449297408,SenseTrump,0,0,0,0,0,3,[],[]
3148402254,donnakbmu11,0,0,0,0,0,5,[],[]
1316702760176365568,RoyShirk7,0,0,0,0,0,0,[],[]
1267449673117241346,nolanw72,0,0,0,0,0,205,[],[]
738091083205201923,WhyLieNews,0,0,0,0,0,71,[],[]
753083980812091392,vorereveluv,0,0,0,0,0,202,[],[]
2273197344,wspickerman,0,1,0,0,0,1535,[],[]
1362582427,Zoot16,0,0,0,0,0,8406,[],[]
905471699272863744,Tlarbb,3,1,0,3,1,800,[],[]
20392696,oh2oh2,0,0,0,0,0,86,[],[]
898230252,brew_schrode,0,0,0,0,0,456,[],[]
89782036,delady49,0,0,0,0,0,6,[],[]
1382108304,JeremyJWaldron,83,5,9,74,2,14837,[],[]
879349924240003072,Artdewolf1,0,0,0,0,0,286,[],[]
56672703,IDigPuzzles,3,0,2,1,0,534,[],[]
1132359691021873153,CoCrWarrior,0,0,0,0,0,21,[],[]
3149358428,FoundationXpert,0,0,0,0,0,109,[],[]
958716163,MikeBates04,14,2,4,10,0,8615,[],[]
818509292252839937,Harrytraylor4,0,0,0,0,0,738,[],[]
911696640662212609,truth_revisited,0,0,0,0,0,1011,[],[]
1211671465386340352,freeeastturki,59,2,17,42,0,6345,[],[]
748268544115126272,nayroftownsvill,1,0,0,1,0,406,[],[]
386746916,Circle_R185,2,0,0,2,0,10429,[],[]
813847616215773185,Williamchristn2,0,0,0,0,0,93,[],[]
607418508,MandiStrachota,0,0,0,0,0,352,[],[]
81524521,ToniAnn2009,0,0,0,0,0,5,[],[]
62729655,armyjohn1,0,0,0,0,0,680,[],[]
603081961,SportsGuyLance,69,16,1,68,0,7237,[],[]
917473956411604992,Shenendoah6,5,0,0,5,0,1562,[],[]
47780751,crimsonrambler,4,0,0,4,0,442,[],[]
36985235,xFriday_Girlx,3,0,0,3,0,2443,[],[]
946576175337492481,EdwinBurke1972,0,0,0,0,0,46,[],[]
1107341592870948864,norfolkngood4,0,0,0,0,0,626,[],[]
1099020647613820929,BlueOfficialMu1,0,0,0,0,0,98,[],[]
2936192889,mario1reyna,0,0,0,0,0,1770,[],[]
22311924,Sinnersaint39,0,0,0,0,0,888,[],[]
1255973100317016069,nunayabeznez,0,1,0,0,0,29,[],[]
49962947,uniqueteacher,1,0,0,1,0,52,[],[]
1111671003699130368,Loves2Rock96,0,0,0,0,0,693,[],[]
76145529,travelman28,0,0,0,0,0,5,[],[]
1288562809786241024,SusanHu92236673,7,0,1,6,1,9,[],[]
752687908730105856,maryfblackwell2,11,0,3,8,1,2856,[],[]
4851231954,Joseph2237J,2,0,0,2,0,18478,[],[]
1250491261158592513,engdork,4,0,1,3,0,8,[],[]
1045117656876158976,iTwooms,0,1,0,0,1,23,[],[]
811660085101400064,PatsLadi99,3,1,1,2,0,7955,[],[]
3883539614,mrxeriscape,2,0,0,2,0,4407,[],[]
36366374,EricGuster,6,0,1,5,0,8668,[],[]
833432825181401089,carmenmesa88,1,0,0,1,0,1536,[],[]
1320518058977406978,SandraFraccalv2,2,1,0,2,0,4165,[],[]
1339419952596606976,slut4antifa,114,5,11,103,1,5432,[],[]
273231152,kimtpicc,0,0,0,0,0,395,[],[]
39242559,Bobp1169,0,0,0,0,0,870,[],[]
1190096097521414144,JohnAssman6,0,0,0,0,0,173,[],[]
15706904,justemilynicole,0,0,0,0,0,2267,[],[]
1321071317341425666,saccoccio_mario,1,0,0,1,0,27,[],[]
1017579807171850240,DarlingRenee1,6,0,0,6,0,412,[],[]
266962708,coolstrongguy,0,0,0,0,0,202,[],[]
1197724513494011904,M94287589,2,1,0,2,0,578,[],[]
4264958733,BarbieSueJ,0,0,0,0,0,5712,[],[]
48618233,RyBrooks,0,0,0,0,0,1007,[],[]
1332684917466165248,Lulu000014,0,0,0,0,0,0,[],[]
881194433886269440,CosmiKid,1,0,0,1,0,1383,[],[]
796751174917562368,ThomasM7796,0,0,0,0,0,16,[],[]
1312393694071357441,alisha72675646,1,0,0,1,0,1,[],[]
90190851,Excalibur2010,0,0,0,0,1,3108,[],[]
796449543000834053,BenjaminGroce,0,0,0,0,0,521,[],[]
411944418,Raymmondragon,0,0,0,0,0,279,[],[]
768999053199749120,Sicilian1926,8,0,3,5,0,6840,[],[]
1290856689625776128,ChrisXrpfuture,0,0,0,0,0,226,[],[]
3273537086,RealCatfish_76,0,0,0,0,0,853,[],[]
1439586715,LilyReflections,7,1,1,6,1,1248,[],[]
255312038,boutiquedebella,0,0,0,0,0,5564,[],[]
465298601,wedonopeneyes,3,0,0,3,0,53203,[],[]
892063667289817088,Anaell630406,0,0,0,0,0,58,[],[]
16719912,kimak,1,1,0,1,0,2123,[],[]
752535146,chiefrocka321,0,2,0,0,0,205,[],[]
922151718,ChrisNarbawlz,2,0,1,1,0,8,[],[]
1255182932,itznthedetails,0,0,0,0,0,4,[],[]
2934083036,RussSegner,1,1,0,1,0,4448,[],[]
1338189538393546753,Moochie96657696,0,0,0,0,0,1,[],[]
958194410684059648,proudpatriot67,0,0,0,0,0,1121,[],[]
2659592984,NaturaSacra,2,0,0,2,0,654,[],[]
952285809998168064,Falcon61372336,0,0,0,0,0,322,[],[]
310282801,ShannonForTrump,0,0,0,0,0,12405,[],[]
3721771522,slnpol,0,1,0,0,0,805,[],[]
929106962,jack_elect,0,0,0,0,0,53,[],[]
1295133219755524102,AprilEv30432215,0,0,0,0,0,294,[],[]
2341003704,lavarro3,0,0,0,0,0,68,[],[]
1862276606,leontrollgosz,1,0,0,1,1,36,[],[]
53003701,sillymickel,65,8,17,48,5,51846,[],[]
1206218254387236864,Catherine13th,0,0,0,0,0,58,[],[]
2355805358,G48Ri3LA_213,0,0,0,0,0,214,[],[]
2440585071,Robertfata1,8,0,1,7,0,4089,[],[]
1327718994061750274,MaryHol94769673,0,0,0,0,0,331,[],[]
2916620562,HoweNhowe1972,0,0,0,0,0,5,[],[]
747810914020245504,Phil_Jones01,2,0,0,2,0,2806,[],[]
51890807,goodclimate,82,15,2,80,1,5426,[],[]
1112830559892508675,AdnAlternative,0,0,0,0,0,1323,[],[]
612783809,norm_ray,1,1,0,1,0,399,[],[]
227813557,wildling_wolf,2,0,0,2,0,350,[],[]
92895347,ronbeatyjr,40,4,11,29,3,7795,[],[]
1106442903532924928,RandyEr39054318,0,0,0,0,0,445,[],[]
2549267581,rasputin_kaboob,1,0,0,1,0,414,[],[]
28900382,arie4,0,0,0,0,0,580,[],[]
12896172,littlebytesnews,1,2,0,1,1,20676,[],[]
2372280505,_beaurobinson,46,3,15,31,3,1697,[],[]
3324845258,OlgaCal95744589,0,0,0,0,0,31,[],[]
264955873,Wcountrygal,0,0,0,0,0,19,[],[]
366866539,JoeeeAz,0,1,0,0,0,333,[],[]
1342751444030660608,EgbeManyo,2,0,1,1,0,52,[],[]
812530871710289920,KanyeObamaTrump,0,0,0,0,0,11,[],[]
24486583,samneezy,0,0,0,0,0,75,[],[]
469348125,danhill2011,10292,694,2783,7509,749,70104,[],[]
1549502226,Maran0613,3,1,1,2,0,276,[],[]
126977940,GrizzlyGovFan,12,2,2,10,0,3985,[],[]
1023375103072133120,DerekSimonis,8,0,0,8,0,874,[],[]
110018867,PVenkatGandhi,0,0,0,0,0,6705,[],[]
2827067565,boggler0U812,0,0,0,0,0,5,[],[]
956373821786935302,TabulaFour,1,1,0,1,0,46,[],[]
2677732812,sergioaromerom,0,0,0,0,0,103,[],[]
3271279164,cmkinmia,59,7,6,53,1,7136,[],[]
972609334751371264,StellaHaley20,0,0,0,0,0,502,[],[]
487224312,AppeaseThis,3,0,0,3,0,5926,[],[]
967401087329357824,GodGivenRight2A,0,1,0,0,0,97,[],[]
1997551,bongopondit,17,1,8,9,0,1078,[],[]
11162592,scottypatriot,0,0,0,0,0,1592,[],[]
228934700,frankchongsh,0,0,0,0,0,70,[],[]
2882989888,Cafewillsaveus,0,0,0,0,0,418,[],[]
1235283733181161472,DoloresCooley15,0,0,0,0,0,0,[],[]
2828870250,psychotroll777,0,0,0,0,0,56,[],[]
112938324,dustintate,2,0,0,2,0,1071,[],[]
1290028849,illiniheel,0,0,0,0,0,52,[],[]
780836646635773952,JacketAnniegonz,0,0,0,0,0,82,[],[]
1098395162638729216,UndefineRender,0,0,0,0,0,362,[],[]
1251075385824927746,JacobCLarson,0,0,0,0,0,170,[],[]
748765704,LatchPrime,0,0,0,0,0,2689,[],[]
838841606077763586,Davidvining101,0,0,0,0,0,886,[],[]
784777117,mt_stjohn,8,4,0,8,0,2612,[],[]
3176796534,Lessweforget57,3,0,1,2,1,368,[],[]
1332438347978072065,pbluto080,0,0,0,0,0,0,[],[]
61465633,chuckr1959,0,0,0,0,0,30,[],[]
1164169536742023177,dandinohill,335,13,105,230,26,7625,[],[]
930971715814940673,dumb_binch_mara,7,2,1,6,0,1198,[],[]
840454566,colonialwarior1,0,0,0,0,0,12,[],[]
1030171629169635329,Carol69852269,0,0,0,0,0,149,[],[]
3375032158,jewelry487jw62,0,0,0,0,0,3636,[],[]
1230947679691108352,CiscoM99,1,0,0,1,0,73,[],[]
1290735327292907522,LivesBusiness,0,0,0,0,0,89,[],[]
1214022773971927040,AmericanTruthFL,1,0,0,1,0,37,[],[]
807990643,JustTobes,0,1,0,0,0,389,[],[]
377769988,Miz_Rosenberg,29,2,1,28,0,2836,[],[]
845449767132037120,ms_ezell,12,0,1,11,0,2081,[],[]
479962730,benjaminrockson,0,0,0,0,0,7,[],[]
23852713,HelMichele,0,0,0,0,0,234,[],[]
820430938035326976,DenSow57,42,3,11,31,2,6208,[],[]
795834802624548864,LoyalLogic,5,4,0,5,0,607,[],[]
401663110,Victoriashleym,12,1,1,11,1,2382,[],[]
1319678204823613440,NanaBea16490200,1,3,0,1,0,1096,[],[]
979896804941561858,RoccoHowat1,7,1,1,6,0,2880,[],[]
442049850,MilesAboveAll,0,0,0,0,0,210,[],[]
1034947399976931328,abecedarian76,6,0,2,4,0,187,[],[]
41700031,BitOBaca,1,0,0,1,0,1162,[],[]
108464247,LeR3ap3r,0,1,0,0,0,329,[],[]
4806442283,vicstmichael,3,0,0,3,0,2053,[],[]
1187171037177434112,Christos4830808,0,0,0,0,0,170,[],[]
599790722,NotoriouslyCute,2,0,0,2,0,528,[],[]
547317369,BTP1960,7,2,1,6,0,2268,[],[]
60478518,cjowalter,0,0,0,0,0,966,[],[]
1142855844364783623,x2da4,0,0,0,0,0,7281,[],[]
19298478,TheCoppensShow,1,0,0,1,0,1117,[],[]
2952738175,melongin_,3,1,0,3,0,61,[],[]
894703634658635777,309Cobra69,104,1,15,89,6,3867,[],[]
1571027462,GaryACarlo,2,1,0,2,0,2754,[],[]
1324089820294111232,glorioso_joyce,1,1,0,1,0,18,[],[]
84190965,1oftheJonesboys,0,1,0,0,0,478,[],[]
34022580,copcake,0,0,0,0,0,105,[],[]
841704092,gwbehn,34,2,18,16,2,3617,[],[]
20998770,RantsOutloud,12,4,0,12,0,4452,[],[]
786412981915492354,America89030131,0,0,0,0,0,1027,[],[]
1250160957889949696,personalrespon1,5,3,1,4,0,8308,[],[]
1240478127475675137,dodge1776,0,0,0,0,0,24,[],[]
710681564347179009,US_Patriot_TX,0,0,0,0,0,612,[],[]
4699060645,bjlang90,0,0,0,0,0,8,[],[]
1320572701950513153,jan_aszman,0,0,0,0,0,15,[],[]
713833510335713280,RobertG32202141,1,0,0,1,0,1651,[],[]
1261010793287561218,johnvento10,0,0,0,0,0,0,[],[]
896220510236942337,LargeSonLogic,0,0,0,0,0,24,[],[]
25178941,brkgnews,1,0,0,1,0,1179,[],[]
2802195397,Elizabeth92260,0,0,0,0,0,9,[],[]
21815317,designerluv1,0,0,0,0,0,3570,[],[]
15731368,HowardKurtz,40,24,10,30,2,160889,[],[]
358545917,Cernovich,2096,345,160,1936,70,887112,[],[]
2439831350,SpeakerMentors,6,1,2,4,0,6014,[],[]
3899743995,TC1984G,0,0,0,0,0,1257,[],[]
913443033714003969,BradTho49929152,0,0,0,0,0,28,[],[]
296036568,rn4lcrh1,0,0,0,0,0,59,[],[]
1210558810114461696,BlakeKortright,0,0,0,0,0,27,[],[]
259108111,cgybarr,3,1,0,3,0,165,[],[]
1122998969859108864,LeninSidious,13,3,3,10,0,1944,[],[]
50681151,MassDaddy,4,2,0,4,0,173,[],[]
821902827689742336,Hammerjack777,2,0,1,1,0,2937,[],[]
3937116137,SurfinBriar,0,0,0,0,0,20,[],[]
434502803,tghoefer,0,0,0,0,0,11,[],[]
822580176483651584,robert_hooton,0,0,0,0,0,958,[],[]
42901906,artist35,0,0,0,0,0,4464,[],[]
1321885579496333313,gul_maga,1,2,0,1,0,21,[],[]
2567315080,makenzielync,0,0,0,0,0,253,[],[]
1278171943,HarveyJSlovis,0,0,0,0,0,638,[],[]
421590138,thomaskishazi,0,0,0,0,0,1,[],[]
310920575,ASmallNicoLatte,16,3,4,12,0,446,[],[]
210623081,TheCoinsMummy,0,0,0,0,0,91,[],[]
1061135474331402240,BetoLuckNexTime,0,0,0,0,0,201,[],[]
1325848574,ewray5,2,1,1,1,0,5530,[],[]
24369408,Linz1981,1,0,0,1,0,308,[],[]
724044995427229696,In_TheArena,0,0,0,0,0,43,[],[]
552742035,tombat4,0,0,0,0,0,1,[],[]
1290698082070540288,Implusive3,1,0,0,1,0,2,[],[]
282106835,mle_anne_,0,0,0,0,0,186,[],[]
632437663,texasrighty,2,0,0,2,0,3836,[],[]
23192199,tceinvestments,0,0,0,0,0,1,[],[]
2363925958,BhamlawJohnny,1,0,0,1,0,764,[],[]
41463654,SamHouston_,0,3,0,0,0,1065,[],[]
953365746691735553,MikeReinbott,0,0,0,0,0,3,[],[]
107307337,JPHX,1,2,0,1,0,1222,[],[]
1015395747997650945,MelissaFellows8,35,3,7,28,0,2197,[],[]
1328456743475560448,NarcisoBeltran4,0,0,0,0,0,5,[],[]
30270036,nlitenmebabe,0,0,0,0,0,1552,[],[]
748600719893106688,lpygray,0,0,0,0,0,149,[],[]
1120147244248735744,Diamond69733459,0,0,0,0,0,0,[],[]
2745022245,libertylovingam,19,0,7,12,0,3563,[],[]
1279909498820292608,ChizerMaurice,0,0,0,0,0,1,[],[]
786035804804120577,patriot_times,0,0,0,0,0,13,[],[]
35011922,11LunchBox,0,0,0,0,0,664,[],[]
169318063,AmandaSoper89,3,0,0,3,0,705,[],[]
845318996689850368,Virginiaculver9,0,0,0,0,0,2,[],[]
869261875,SAPOMBOR,0,0,0,0,0,77,[],[]
88082255,dave224422,0,0,0,0,0,43,[],[]
880446976680132608,NICKBKNYUSA,10,0,2,8,0,1148,[],[]
116464453,studebiker,1,1,0,1,1,87,[],[]
22828837,brettglass,1,0,0,1,0,1489,[],[]
1321213170279591937,KateKahn12,0,0,0,0,0,5,[],[]
3231657095,AnthonySabatini,53601,1434,8605,44996,914,87820,[],[]
1161124696684761088,jhtweets_,25,1,0,25,0,1502,[],[]
754303782851268612,wheattree5,0,0,0,0,0,102,[],[]
1339139496223207424,boardwalk_wire,0,2,0,0,0,18,[],[]
1235166859789512704,MarionDrouin,0,1,0,0,0,12,[],[]
1266013507591507970,RainingYarrow,0,0,0,0,0,259,[],[]
1073442128271859712,BarbadosDoc,10,0,1,9,0,609,[],[]
80634361,bjweinman,3,0,0,3,1,1523,[],[]
1322394626792312832,MAGA4Ever503,0,0,0,0,0,439,[],[]
418181171,ALLEETEE1,1,0,1,0,0,1873,[],[]
532554874,China_Germany,0,0,0,0,0,72,[],[]
1250608561073291265,Charlen16331042,0,0,0,0,0,309,[],[]
2411388420,SandraYozipovic,2,0,0,2,0,2815,[],[]
1318014220303278080,GaryTho77793205,0,0,0,0,0,1583,[],[]
248879227,tony3879,1,1,0,1,0,191,[],[]
626081549,realVikingCat,20,0,3,17,1,3465,[],[]
1249136548651520001,Knuckles131,0,0,0,0,0,2127,[],[]
3291720388,StevenJacobetz,0,1,0,0,0,126,[],[]
785306138757754882,carrie_saveUSA,2,0,0,2,0,1098,[],[]
936788589622435842,JerasIkehorn,114,9,33,81,3,23057,[],[]
1282209413244219392,SuperMonkeBeing,1,0,0,1,0,138,[],[]
785153200366112768,ImDag_,0,0,0,0,0,68,[],[]
1265336732720877568,reneintokyo,0,0,0,0,0,0,[],[]
953745466109431808,ESurfdream,0,0,0,0,0,54,[],[]
1321867374069514243,Razvan27309728,0,0,0,0,0,3,[],[]
934941924955484161,DCCWrules,168,5,58,110,5,1097,[],[]
1199340468498251776,Strongest52,0,0,0,0,0,214,[],[]
1264345504244269058,trey50346128,2,0,0,2,0,6,[],[]
890055605016199169,TBUJosh,1,0,0,1,0,697,[],[]
174534278,alemap326,0,0,0,0,0,63,[],[]
20164032,Ekklesia_co_uk,7,0,3,4,0,11754,[],[]
37034589,MajorPayne15,0,0,0,0,0,556,[],[]
35867454,wybetter,1,0,1,0,0,5069,[],[]
1205220874741092352,AlexaStankiewi2,2,0,1,1,0,6,[],[]
222847574,pelletir,0,0,0,0,0,51,[],[]
1256792669969428481,gunz3379,9,0,1,8,0,1778,[],[]
788790284515618818,DALEODRUMMER,0,0,0,0,0,8,[],[]
514708269,Aaronyourface,0,1,0,0,0,270,[],[]
1085263095189176320,PeggySueLindse1,0,0,0,0,0,0,[],[]
831533696905859076,Patrici65769241,3,0,1,2,0,3055,[],[]
1297333633439731715,dante_witter,2,0,0,2,0,3,[],[]
759416736110096384,hallglaze,0,0,0,0,0,32,[],[]
787753885,arribas_june,2,0,1,1,0,2295,[],[]
1000759300074061824,Eldermld1,3,0,0,3,0,4903,[],[]
461545658,AllllRighty,0,1,0,0,0,88,[],[]
44384976,malinablue,52,14,8,44,2,61817,[],[]
172528558,gofull07britney,2,0,1,1,0,24,[],[]
1104362593,4merl,0,0,0,0,0,28,[],[]
75962288,dekeriverscp,3,1,0,3,0,197,[],[]
1325171878043021312,JakeJak50951314,0,0,0,0,0,8,[],[]
201931078,desert1vet,0,0,0,0,0,997,[],[]
1342716573887442944,demonicomelette,0,0,0,0,0,0,[],[]
20700936,xwiseguyx,1,0,0,1,0,541,[],[]
1191597871620952065,RWoodson20,21,1,4,17,0,1927,[],[]
41056882,klstephe,0,0,0,0,0,3,[],[]
821649521725808644,DawnRSutton2,0,0,0,0,0,2,[],[]
1314083984196935682,courtne84824912,0,0,0,0,0,47,[],[]
2290018836,BernyWhistle,0,0,0,0,0,17,[],[]
1585779517,YCGreer,7,0,0,7,0,100,[],[]
926383201899241472,FightinforUSA,0,0,0,0,0,1000,[],[]
58746872,911news,0,1,0,0,1,6101,[],[]
755557986123255808,dlbforbama,0,0,0,0,0,1886,[],[]
1012530484784615425,nick63870530,0,0,0,0,0,1,[],[]
169704746,Greg_Matteson,10,2,3,7,1,57,[],[]
804363363375411200,gardengirl125,4,2,0,4,0,11425,[],[]
823937319426281475,bare_image,1,0,0,1,0,168,[],[]
72175800,proud2bTexan,2,1,1,1,0,5830,[],[]
1119237475837325314,REALLYURKIDING,18,1,3,15,2,2545,[],[]
187021920,almac7477,0,0,0,0,0,1619,[],[]
244814505,scottlong1980,4,0,1,3,0,3303,[],[]
77618400,i__Am__Brooks,1,0,0,1,0,649,[],[]
836573844357906432,Liberallogic5,2,0,1,1,0,9361,[],[]
951698803731525632,PNWnCHILL,0,0,0,0,0,77,[],[]
1304462689721344002,CatPoacher,1,0,0,1,0,3417,[],[]
709617362396454912,NoTrump4me,55,5,13,42,4,7407,[],[]
797645451260469249,USAMarineMomma,0,0,0,0,0,18607,[],[]
1961606270,CO_contraband,1,0,0,1,0,1049,[],[]
1049992227194368001,oDb__,1,0,0,1,0,5168,[],[]
773689903955714048,cornell11621201,0,0,0,0,0,2,[],[]
1537312639,TapIntoSuccess,0,0,0,0,0,132,[],[]
1676147881,RealM_Shrimpton,21,3,4,17,0,382,[],[]
109967135,CjHollidayWWG,9,0,2,7,0,8766,[],[]
2402553290,BAWare9,2,0,1,1,0,2831,[],[]
1266032176040218625,betty_mingo,13,1,2,11,0,5619,[],[]
958747292554727424,Kermit46379364,0,0,0,0,0,1,[],[]
809215890722082817,Noregrets2024,0,0,0,0,0,3219,[],[]
227799486,RudimentaryLife,0,0,0,0,0,80,[],[]
13413,Mickeleh,5,0,1,4,0,5513,[],[]
727312014792658945,SlyLovgren,0,0,0,0,0,2028,[],[]
29999100,Allan_Brown35,0,0,0,0,0,139,[],[]
18948741,jltrahan,0,0,0,0,0,590,[],[]
1217583866426249216,1TomGebhardt,0,1,0,0,0,20,[],[]
954606889236496384,KathyOC63783924,3,0,1,2,0,3249,[],[]
187578616,horowitz39,223,11,49,174,1,82996,[],[]
60094238,garethbotha,0,0,0,0,0,655,[],[]
552074490,phxazgrl,4,0,1,3,0,1305,[],[]
747780338,triEyeLite13,5,0,0,5,1,245,[],[]
92092714,coreyraaflaub,2,0,0,2,0,380,[],[]
1128478358831022080,chrisHo27338604,0,0,0,0,0,77,[],[]
1342460627051286529,JimFox83328703,0,1,0,0,0,0,[],[]
50695389,MikeSullivan68,0,0,0,0,0,64,[],[]
2778989708,noyzrost,5,0,0,5,0,16195,[],[]
1266412276539625472,001maxlogic,2,0,1,1,0,287,[],[]
456491089,BadgerLiberal,3,0,2,1,0,2502,[],[]
14163898,ravenwolfsmoon,1,0,0,1,0,1838,[],[]
977421937478643712,HeustonP,0,0,0,0,0,1062,[],[]
1221995649308061698,KBittermanGross,0,0,0,0,0,435,[],[]
1284896035576389633,dean_woolston,0,0,0,0,0,0,[],[]
21897322,mrsunshine44,0,0,0,0,0,5121,[],[]
788865888007118848,Gigiluvs2020,3,2,0,3,1,12227,[],[]
233664559,RilezTweetsEsq,37,3,4,33,1,8829,[],[]
934462911891820544,Sparky6461,8,0,3,5,0,1828,[],[]
1054052650503802881,Stylecr8r1,6,1,1,5,0,998,[],[]
890996411105411072,brwnhaze,0,0,0,0,0,111,[],[]
1143261355,Llunakittie,2,0,0,2,0,228,[],[]
1322961522893725700,stapapool,13,3,2,11,0,2315,[],[]
90584877,ginamcb,0,0,0,0,1,104,[],[]
263402537,koi529,61,5,16,45,0,13583,[],[]
1202273618975047682,Lawrenc32250953,1,0,1,0,0,65,[],[]
749065941028376576,bobbymckinley33,0,0,0,0,0,399,[],[]
4865334489,WAllenLong,0,1,0,0,0,2,[],[]
1335498798307524608,TaxTheftGov,0,1,0,0,1,114,[],[]
1533459110,OldUnclePunch,0,0,0,0,0,4355,[],[]
999453985,BlissTabitha,81,11,34,47,6,106830,[],[]
133575103,Hilohaw,3,0,0,3,0,3722,[],[]
2639056944,Hexabeastie,3,3,0,3,0,1058,[],[]
493259386,anicole1011,0,1,0,0,0,253,[],[]
824474928296718336,John37298511,1,0,0,1,0,220,[],[]
69686220,trumparama,11,2,1,10,1,3606,[],[]
931289130,LadyRoyMustang,0,0,0,0,0,3395,[],[]
1325263429020622848,ks328438471,3,0,0,3,0,162,[],[]
1025448164,pappymac13,1,0,1,0,1,863,[],[]
1217778954486067200,mdwoody1958,1,0,0,1,0,2,[],[]
67958492,hvac69,0,0,0,0,0,4119,[],[]
2595264354,pcatanzaro1,0,0,0,0,0,26,[],[]
3866058553,sandi_bernier,0,0,0,0,0,15,[],[]
1342501887850008578,srarthu21028812,0,1,0,0,0,5,[],[]
984614636,MylandBurke,3,5,0,3,0,691,[],[]
328792601,LoblollyPines,1,0,0,1,0,4131,[],[]
44739231,kensouder,4,2,0,4,0,225,[],[]
1039300610758201345,TheMiddle33,4,0,0,4,0,3039,[],[]
1272922539501723661,wiseone41002139,0,0,0,0,0,0,[],[]
2416566847,DoctorsOverseas,6,0,0,6,0,1952,[],[]
315738397,tigersowners,0,0,0,0,0,196,[],[]
2288973380,joel_eisenberg,5,0,0,5,0,3357,[],[]
28096743,wayt_4me,0,0,0,0,0,193,[],[]
326457795,donnawnts2no,0,0,0,0,0,5293,[],[]
1300939004712546304,lBlackListedl,0,0,0,0,0,18,[],[]
863443145354301441,lifeisalwaysfun,1,0,0,1,0,5183,[],[]
481697815,me_infj,4,0,1,3,0,2590,[],[]
942135368,unionredelectri,0,0,0,0,0,3432,[],[]
606893578,brendalshaw,0,0,0,0,0,31,[],[]
864851592524312577,elder_patriot,1,0,1,0,0,1234,[],[]
589199645,jeannage2003,0,0,0,0,0,3,[],[]
89323576,BaconKnight,0,2,0,0,0,2273,[],[]
1328296149028118528,jlbustem,1,0,0,1,0,8,[],[]
799662010006929408,jubileecyn,2,0,1,1,0,19,[],[]
844634541201539072,KeithDavistrio,0,0,0,0,0,359,[],[]
870930491100151812,timber_george,2,1,0,2,0,1,[],[]
34999868,purecolorartist,0,0,0,0,0,34,[],[]
971796616213561344,RNR_Georgia,8,0,2,6,0,3049,[],[]
4552089494,TheRealNoehJrF,0,0,0,0,0,57,[],[]
931190828948738049,ClayJrStaves,9,0,2,7,0,570,[],[]
1241339840236523520,Ray10385775,0,0,0,0,0,1,[],[]
60866932,80_homer,0,1,0,0,0,168,[],[]
559431623,_Rowlf,16,0,2,14,1,15735,[],[]
1194290051766722565,FloridaSteve777,3,0,0,3,0,1591,[],[]
561589783,corymach7,3,7,2,1,0,41,[],[]
740050247229939714,PFC_McWanker,0,0,0,0,0,24,[],[]
1342954950196944897,RGreedhater,0,0,0,0,0,1,[],[]
273668481,_iMelb,0,0,0,0,0,1177,[],[]
196577393,howardhacker,0,2,0,0,0,101,[],[]
847738868375838721,LilliBeeSummers,0,0,0,0,0,845,[],[]
3941587822,yourowngravity,0,0,0,0,0,136,[],[]
1320408835358658561,Kit71905811,1,2,0,1,0,6,[],[]
1107172797871284224,NoNationPhoto,0,0,0,0,0,91,[],[]
1342051435656187904,seeker_vision,0,0,0,0,0,3,[],[]
1195821639029723141,stevesi03656269,0,0,0,0,0,90,[],[]
905166742414118914,realRudyRusso,1,0,0,1,0,474,[],[]
1082368160932732933,progrocker5,1,0,0,1,0,182,[],[]
733609304322904064,RealityStriker,0,0,0,0,0,1442,[],[]
23941190,here4younow,0,0,0,0,0,168,[],[]
1299650702537641984,bunnygirlpilled,64,2,3,61,0,1996,[],[]
1093742454438690816,weloveleighh,1,0,0,1,0,157,[],[]
256208040,msnicole329,1,0,0,1,0,3253,[],[]
28623510,proadstudio,6,1,1,5,0,24338,[],[]
2859443952,OmariWarren,3,1,0,3,0,4526,[],[]
1295393902938136576,BlackandBrown5,0,0,0,0,0,173,[],[]
215181023,aj_red9er,0,0,0,0,0,38,[],[]
4288205839,johnnie_torch,3,0,0,3,0,2004,[],[]
988938727132160001,gonoyacruces1,0,0,0,0,0,302,[],[]
91468153,FriendChuckR,0,0,0,0,0,990,[],[]
480998405,PJpjki,0,0,0,0,0,22,[],[]
1246863810880614400,Harry43521235,1,0,0,1,0,1081,[],[]
734970729066823680,edwardtoyou2,3,0,1,2,0,398,[],[]
1332406725077585923,Ruby16972618,3,0,1,2,0,88,[],[]
1876106299,EnkiSpeaking,0,1,0,0,0,2711,[],[]
1252114195178389505,Nataka_uachane,0,0,0,0,0,52,[],[]
309971588,RCvengros,0,0,0,0,0,55,[],[]
808617989360799744,trump_friends,4,0,1,3,0,2068,[],[]
54264748,liathfaol,0,1,0,0,0,262,[],[]
3861055154,TH55202331,0,0,0,0,0,4281,[],[]
1240303056,SithLordPooh,2,0,1,1,0,330,[],[]
246924495,webakimbo,1,0,0,1,0,93,[],[]
33682873,JayBennington,0,0,0,0,0,445,[],[]
3795043660,princess_kim_k,40,4,9,31,0,50823,[],[]
1512700219,captainwaller,1,0,0,1,0,829,[],[]
2321020159,patriotproud21,0,0,0,0,0,439,[],[]
1950853916,RussSorite16,0,0,0,0,0,447,[],[]
1279509514111205376,kellsmill,2,0,1,1,0,1523,[],[]
1167665928265273344,PipeLay77487238,0,0,0,0,0,0,[],[]
2590162042,Cazonci98,4,0,0,4,1,3997,[],[]
1272368604055392256,BriardMike,0,0,0,0,0,0,[],[]
59849033,MsTrishia,1,1,0,1,0,12281,[],[]
2810019572,godagape1,0,0,0,0,0,37,[],[]
15240855,getradified,8,1,0,8,0,2825,[],[]
897604939324702721,PatrishiaAvery,0,1,0,0,0,3932,[],[]
1282316726227603457,LloydPo15971806,0,1,0,0,0,3688,[],[]
725303094,RogHolland,0,0,0,0,0,49,[],[]
1947656546,WhoisAEllis,7,0,1,6,0,1831,[],[]
1314053956461563909,keravelt,0,0,0,0,0,12,[],[]
19097032,hlhamphall,5,1,1,4,0,753,[],[]
1301734062269198336,BuultjensJerome,0,0,0,0,0,1,[],[]
939993359472627717,williamrharvey,1,0,1,0,0,487,[],[]
26870804,Cheyene1968,1,0,0,1,0,143,[],[]
152649736,1angryliberal,0,0,0,0,0,37,[],[]
1254865758120804353,Teeth_Shoes,0,0,0,0,0,125,[],[]
1274683376759451650,CancelSeason2,19,2,2,17,0,8573,[],[]
30076051,BGO1950,0,0,0,0,0,1112,[],[]
1121380926360051713,Billyke86932499,0,0,0,0,0,357,[],[]
72143739,TylerThacker21,1,0,0,1,0,326,[],[]
254066200,annette0626,2,0,1,1,2,336,[],[]
381887093,ebeth_murph,0,0,0,0,0,137,[],[]
87612386,csharpner,9,1,2,7,0,1750,[],[]
25650659,donniecopeland,2,1,0,2,0,6025,[],[]
1224166856040173569,TheMarcitect,3,0,0,3,0,40089,[],[]
966836251402866694,elVellichor,2,0,1,1,0,17240,[],[]
1100495923522592768,QuetzalThoughts,0,0,0,0,0,568,[],[]
96771653,eracindyhaas,0,0,0,0,0,3,[],[]
1233799569881780224,SoulSurvivor24,2,0,1,1,0,172,[],[]
1336771185384824840,ForeverFree2020,0,1,0,0,0,8,[],[]
816844094609600512,dcziggy2,6,1,2,4,1,14297,[],[]
1340252862903951365,Cate1Hrh,19,5,2,17,1,610,[],[]
1330911859889885188,Unknown03010958,2,0,1,1,0,0,[],[]
778956152780517376,JohnJrNY,8,0,1,7,0,684,[],[]
15906168,RobertLehrer,0,0,0,0,0,300,[],[]
437895421,RayGiles1,1,0,1,0,0,569,[],[]
765606434255937536,DanaAronBurr,0,0,0,0,0,1,[],[]
1026576700610621441,LangmanVince,478,45,122,356,20,34929,[],[]
31659950,HeavenCanW8t,2,0,1,1,0,2102,[],[]
1301915596377010183,2020istrash2020,2,0,1,1,0,1619,[],[]
1250454117815848963,N8TheCre8tive,0,1,0,0,0,2775,[],[]
3166113390,rgtzelgiusti,0,0,0,0,0,3,[],[]
157770281,brianavachal,0,1,0,0,0,489,[],[]
1285232774,Dealing4Meaning,0,0,0,0,0,1738,[],[]
3022969687,CntrobertsChris,0,0,0,0,0,27,[],[]
405230192,Scottsman1048,2,0,1,1,0,117,[],[]
734347591,NewMilenioRadio,0,0,0,0,0,19,[],[]
834248645096644608,pauls_nyc,0,0,0,0,0,475,[],[]
1105627334823108610,jdh152,9,0,1,8,0,2331,[],[]
2865669265,6fc5ec2088d8422,0,0,0,0,0,1153,[],[]
79031518,ElayneBoosler,349,14,56,293,2,57830,[],[]
566770434,gaby_kantor,42,1,10,32,0,1724,[],[]
1183864265771499522,jamespe85812107,0,0,0,0,0,0,[],[]
1017970850052468736,Lauren38060467,29,3,5,24,1,5998,[],[]
1260353049039699969,Travis95682363,2,0,1,1,0,174,[],[]
1302455297483522048,RealFrankJMcCa1,67,5,14,53,1,6700,[],[]
38798644,MattC2334,0,3,0,0,0,229,[],[]
724604895140171777,VectorSubsix,0,0,0,0,0,48,[],[]
