User ID,User Name,Node_weight,Reply Count,Retweet count,Like Count,Quote Count,Followers Count,FOllowerID,Follower name
84208310,KnoxDems,25,0,1,24,1,4859,[],[]
262426560,nephilim_92,1,0,0,1,0,432,[],[]
366280678,thedailyloren,0,0,0,0,0,2422,[],[]
38445467,senatorshoshana,99,15,1,98,0,63928,[],[]
983308324421677056,TexanUsa42,0,0,0,0,0,7234,[],[]
755358836907659265,BWaipio2014,0,0,0,0,0,57,[],[]
817543453324222464,teddyroorooroo,1,0,0,1,0,22,[],[]
896725005333082113,linda_brickley,2,0,0,2,0,1207,[],[]
1341124416298758148,Allen68983950,0,0,0,0,0,2,[],[]
2318006749,JoanEFarr,1,1,0,1,0,36,[],[]
268334292,cynthiagibas,1,1,0,1,0,761,[],[]
24045433,thrystero,0,0,0,0,0,93,[],[]
333814482,MannySchewitz,2,0,0,2,0,2778,[],[]
18128717,7Veritas4,18,0,2,16,0,51050,[],[]
20553293,MitchMcGrew,3,0,0,3,0,290,[],[]
741364964653432832,kkbrando,2,1,1,1,0,11877,[],[]
14246657,SteveKrak,2,1,0,2,0,42823,[],[]
908410870505644032,brruer,0,0,0,0,0,206,[],[]
24143648,TalesofToday,0,0,0,0,0,155,[],[]
37002952,Jotan70,2,0,1,1,1,249,[],[]
3041292656,JustInCaseKate,98,18,10,88,1,13505,[],[]
1090272099531276295,proudKAGwarrior,14,1,4,10,0,3381,[],[]
1103652165569167360,StarkNakedBrief,19,0,3,16,0,5051,[],[]
17408988,Machovell1an,25,3,2,23,4,3449,[],[]
2859359664,1_4915,0,0,0,0,0,5,[],[]
853816543850799104,HassanMusharba1,0,0,0,0,0,0,[],[]
19896211,wphamilton,7,0,1,6,0,11899,[],[]
16452967,danmoser1961,14,3,0,14,0,1359,[],[]
1117393160949444608,bren_fieldX,0,0,0,0,0,596,[],[]
57417356,jjarhead,0,0,0,0,0,3555,[],[]
3396180653,karenmabry7,0,0,0,0,0,47,[],[]
1199455452,bigdaleenergy,0,0,0,0,0,269,[],[]
1249711604985364481,lisachristinect,59,21,7,52,0,20910,[],[]
505514391,CBurnzy32,4,2,0,4,0,298,[],[]
370171816,the_masterswife,0,0,0,0,0,81,[],[]
15751676,MattNegrin,1931,17,325,1606,16,70916,[],[]
71562856,heartsmarttela,5,0,2,3,0,364,[],[]
67906517,Basketballisbes,0,0,0,0,0,1622,[],[]
704863841092505600,DonaldDrumpfWTF,3,0,0,3,0,4104,[],[]
198229231,CANTTTHINKJOY,0,0,0,0,0,302,[],[]
1344739480050294787,AmericanREI5_2,1,0,0,1,0,114,[],[]
607876350,mark_federighi,1,0,0,1,0,114,[],[]
1178052330542907392,IAmtheAZLiberal,4,0,1,3,0,232,[],[]
1318974034084794375,llygaidllwyd,9,2,2,7,1,387,[],[]
165574094,bobsaysdrink,19,2,0,19,0,2921,[],[]
1181233434322227200,ChuckSpringborn,2,0,1,1,0,5,[],[]
40854194,Diamondsinoil,0,0,0,0,0,72,[],[]
868138245669912577,Irretnnyl,2,0,1,1,0,541,[],[]
1296338870,307WindyWyoming,3,0,1,2,0,678,[],[]
260876366,Mark___Gardner,0,0,0,0,0,118,[],[]
466760142,Beard_o_freedom,0,0,0,0,0,20,[],[]
904174645,CStrait2,17,1,3,14,0,3905,[],[]
2293797811,JLaurenceCohen,2,0,0,2,0,397,[],[]
719328080808910850,ArtsGuySD,0,0,0,0,0,135,[],[]
777865165534560256,Bowbeforezod197,1,3,0,1,0,955,[],[]
1254213767791075330,left_site,1,1,0,1,0,1287,[],[]
2975091705,CongressmanHice,990,132,212,778,37,90020,[],[]
1303566863373393920,JimRock15557938,2,0,1,1,0,26,[],[]
3258423358,RN_DNP_CRNP_MPH,0,0,0,0,0,6694,[],[]
776570051696754689,JerryWill01,2,0,0,2,1,1236,[],[]
55841409,ableraces,11,1,2,9,1,15344,[],[]
859539020841439232,blechtimes,0,0,0,0,0,1065,[],[]
454640361,IamNurseTrish,1107,124,135,972,10,17281,[],[]
772514870650630145,FrisellJake,1,2,0,1,0,419,[],[]
1260657562392891392,robertf06416539,0,0,0,0,0,5,[],[]
1332977672029396993,jhszm,0,0,0,0,0,1,[],[]
16807775,mikeofkorea,0,1,0,0,0,283,[],[]
313941292,graygoogirl,1,0,0,1,0,981,[],[]
1398275840,Anon2World,214,13,32,182,4,69349,[],[]
3419219055,adrianeisoverit,4,0,1,3,0,1080,[],[]
48207210,justinruff,1,0,0,1,0,9326,[],[]
3439044209,Juliolcubano,21,1,4,17,1,6906,[],[]
116015475,scottjonez,2,1,0,2,0,579,[],[]
23821000,jewinthesun,2,0,0,2,0,89,[],[]
1326697744883453956,OsrsNabs,0,0,0,0,0,235,[],[]
46930133,orbidale,0,1,0,0,0,192,[],[]
755210244377104384,BigSargeSportz,8,3,3,5,0,4562,[],[]
30470425,JimmyBCT,0,0,0,0,0,127,[],[]
387162020,FlowerInFaith,0,0,0,0,0,3360,[],[]
763135149706010626,DougGarrison12,0,0,0,0,0,45,[],[]
2912378149,Clay_kicker,0,0,0,0,0,129,[],[]
1053023246,iczimm,0,0,0,0,0,2945,[],[]
402888514,djrothkopf,2742,118,473,2269,38,267569,[],[]
23745304,Truth247,2,0,1,1,0,5652,[],[]
974259030,jamesG87776821,0,0,0,0,0,489,[],[]
250695330,FlapFriesland,9,2,0,9,0,11284,[],[]
52073060,WinstonOnData,0,0,0,0,0,1308,[],[]
413826737,Sheff36,6,0,3,3,0,1368,[],[]
149242357,fakebobbygatlin,0,0,0,0,0,66,[],[]
4258072156,ismartyforever,0,0,0,0,0,202,[],[]
962751546235613184,PaTresha10,3,1,1,2,0,3781,[],[]
1259991965271195649,MamaSaysNo1,9,0,1,8,0,4077,[],[]
984525902225727488,ProfCRobertson,2,0,0,2,0,1244,[],[]
2863996955,RWPUSA,39729,548,9413,30316,721,755592,[],[]
39630997,JohnLairdTXWA,1,0,0,1,0,475,[],[]
1329807907,ShirleyRagsdale,0,0,0,0,0,605,[],[]
1245154702804877313,roski18698314,2,0,1,1,0,12,[],[]
1086402743206502401,gospel_sod,53,3,1,52,1,2798,[],[]
163987185,HeathMayo,4767,201,505,4262,62,54404,[],[]
1186153241026928641,WinnerGetsNoPod,0,1,0,0,0,2768,[],[]
1199521874541236224,JenMedi5420,0,0,0,0,0,47,[],[]
807863028,goldensrule36,0,0,0,0,0,31,[],[]
2206722907,GillSarjeet,0,1,0,0,0,7592,[],[]
2298415738,SurvivorLivvy,4,0,0,4,0,394,[],[]
7591572,asmith83,160,2,35,125,0,20211,[],[]
894232696280408065,PerpetuityPhoto,0,1,0,0,0,90,[],[]
14304930,dgolumbia,21,3,2,19,0,7765,[],[]
2889924959,TrueFactsStated,753,9,97,656,3,229660,[],[]
79788701,TheMyronB,0,0,0,0,0,369,[],[]
54102370,TCSCushing,2,1,0,2,0,1045,[],[]
915386679669739520,WCtdtc,1,0,0,1,0,261,[],[]
76533897,nixon000,1,1,0,1,0,49,[],[]
2273094146,Jan76Jones,0,0,0,0,0,71,[],[]
71959874,WyoBronco,1,0,0,1,0,255,[],[]
346523098,mpchanzo,0,0,0,0,0,15,[],[]
35747874,rames09,0,0,0,0,0,66,[],[]
393807640,tori_teresa,5,1,0,5,0,636,[],[]
847491998508474370,FinFox2,14,0,1,13,0,34778,[],[]
2741989134,SimpsonCrown,1,0,0,1,0,542,[],[]
5468322,shoobe01,3,0,1,2,0,2685,[],[]
823292597137379328,JuliBunting,71,7,17,54,0,16749,[],[]
110431691,captaintweet151,2,0,1,1,0,210,[],[]
145344704,AttorneyGriggs,249,7,56,193,3,38826,[],[]
63747308,DiegoUK,1,0,0,1,0,6758,[],[]
825892271052771332,YouRebelScum77,8,0,1,7,0,13,[],[]
22699138,tacosyUnacoca,0,0,0,0,0,77,[],[]
153560578,BlaQNall4,1,0,1,0,0,642,[],[]
1280671474316124160,DavidRo67855548,0,0,0,0,0,50,[],[]
1181355577357697024,FrankFranoosh,0,0,0,0,0,60,[],[]
1385348989,jmlufi,2,0,0,2,0,42,[],[]
259371034,yason_bookman,1,0,0,1,0,171,[],[]
173517116,tcurranmd,1,0,0,1,0,1754,[],[]
50476888,LaurieWJN,0,0,0,0,0,2237,[],[]
824152162699800576,Jamie_Nunya,3,1,0,3,0,1925,[],[]
19846330,shillman1,286,29,27,259,2,25453,[],[]
29974019,TheNonReporter,4,0,0,4,0,985,[],[]
1278994355496329216,JGreenwelt,0,1,0,0,0,15,[],[]
848554169556402176,steven_demarest,1,0,0,1,0,2759,[],[]
865709988936921088,Deborah463874,0,0,0,0,0,14,[],[]
3729123861,hardeclarks,1,1,0,1,0,1847,[],[]
1087875742401208320,john_kimzey,0,0,0,0,0,3,[],[]
531565190,JimAex,0,0,0,0,0,35,[],[]
1008115207271518209,LogicIntegrity,10,0,2,8,0,1199,[],[]
1171566080424390656,RoadtoPOTUS,0,1,0,0,0,10,[],[]
170302722,pamplainandtall,1,0,0,1,0,567,[],[]
22372917,truthfighter1,6,0,1,5,1,17216,[],[]
20188209,ATKII,1,0,0,1,0,960,[],[]
188958822,cincykids,5,1,1,4,1,1230,[],[]
330687981,RebeccaOtte,0,0,0,0,0,446,[],[]
16640074,tenniskev,0,0,0,0,0,86,[],[]
809470366322040832,album60054,1,0,0,1,0,56,[],[]
817928004,corza513,2,0,0,2,0,248,[],[]
2335898299,wheellifter2000,0,0,0,0,0,175,[],[]
2845301,bfordham,1,0,0,1,0,526,[],[]
818989048077438980,YouthGoneWildOK,0,0,0,0,0,176,[],[]
856708977912037376,rdaneel_eth,14,1,0,14,0,1558,[],[]
1276900617324236808,AmberStiles80,14,1,2,12,0,12838,[],[]
362114284,Rhaegaro,64,2,5,59,1,15396,[],[]
595616527,kaitlynhopkins_,10,1,2,8,0,80,[],[]
68795463,XenaResists,2,0,0,2,0,5476,[],[]
101289763,urbanharp,1,1,0,1,0,283,[],[]
1232161857034760192,allidoismix,204,42,32,172,14,11625,[],[]
36746972,battletested5,254,7,44,210,2,25233,[],[]
1059429965681152000,Soultry4,232,18,47,185,9,4721,[],[]
934135530639409152,godless_doc,5,0,1,4,1,2917,[],[]
2795838083,anaious,0,0,0,0,0,639,[],[]
486028131,jmahoney40,0,0,0,0,0,9,[],[]
1345598978432397313,PaulPatrickTho1,0,0,0,0,0,34,[],[]
988201168068399104,CrepuscularOhio,0,0,0,0,0,231,[],[]
232666598,desmanufan,0,0,0,0,0,18,[],[]
277879045,yfabb,0,0,0,0,0,1159,[],[]
3722137941,WhippetRun,0,0,0,0,0,1830,[],[]
1197266595929829383,Jason68104097,3,4,0,3,0,151,[],[]
3032025483,karenjaco1,0,0,0,0,0,476,[],[]
1326896453206347776,Yew_freedom,0,0,0,0,0,18,[],[]
862863796800561152,MPachy1,0,0,0,0,0,5,[],[]
2824436388,roninalamosa,0,0,0,0,0,26,[],[]
141946248,GeoffH3,1,0,0,1,0,802,[],[]
14667826,jordangerous,47,3,4,43,0,4179,[],[]
182433847,JudyOR,4,0,0,4,0,1884,[],[]
718389989,Lastdocpa,1,0,0,1,0,4307,[],[]
31030692,robjack001,1,0,0,1,0,37,[],[]
98748056,NYDKFL,0,0,0,0,0,516,[],[]
41673456,rjgerwin,0,0,0,0,0,122,[],[]
948343438235205632,DarthTrader_FL,0,0,0,0,0,109,[],[]
82161116,rpwestcott,157,4,33,124,3,38169,[],[]
723629859285557249,agent00wtf,1,0,0,1,0,357,[],[]
1271818682675666946,MightyMichMich,8,0,2,6,1,1335,[],[]
138176921,sheaspillane,1,0,0,1,0,898,[],[]
2569415413,ItsMeDoublEE,4,1,1,3,1,478,[],[]
60214566,CyndiMenzel,1,0,0,1,0,314,[],[]
407214521,InBedx,0,0,0,0,0,42,[],[]
14325500,jwclark,0,0,0,0,0,330,[],[]
291458784,JoieBooks,2,0,1,1,0,434,[],[]
1053271752,astronglady,0,0,0,0,0,1952,[],[]
15907183,cmclymer,3254,92,426,2828,30,384651,[],[]
890653225430528005,jo_jlsr3353,0,0,0,0,0,2595,[],[]
203636804,mato66,0,0,0,0,0,820,[],[]
249468047,CAValleyJake,0,0,0,0,0,317,[],[]
981163834630078465,DonCar177,0,0,0,0,0,41,[],[]
3101980190,Boadicea12,0,0,0,0,0,1433,[],[]
821049827635134464,ajsonderman76,4,0,1,3,0,3,[],[]
59461869,KennethRear,1,0,0,1,0,106,[],[]
2200993352,NickVaky,0,0,0,0,0,577,[],[]
1311282884129566722,JunkiePoltical,0,0,0,0,0,11,[],[]
1240662863586476033,Elena09398865,0,0,0,0,0,1227,[],[]
1942483842,Mayeyala,2,0,1,1,0,6795,[],[]
1011603775914725377,ericthered41,2,0,0,2,0,93,[],[]
919960649341452288,BanksClan,0,0,0,0,0,1004,[],[]
63100267,grandpadano,0,0,0,0,0,8,[],[]
539492347,sparklyflagpin,0,0,0,0,0,694,[],[]
1280670913848057856,LowOnHealth65,0,0,0,0,0,2014,[],[]
1917522950,brina99cary,1,0,0,1,0,579,[],[]
1265760586681499650,Turkeytoon2,0,1,0,0,0,43,[],[]
50029018,NikkiD111,1,1,0,1,0,76,[],[]
2927466334,purebeaux,4,0,2,2,0,16,[],[]
1307400908066652162,RM04200170,0,0,0,0,0,44,[],[]
1137033067128926214,Jennanrun,12,0,0,12,0,3742,[],[]
1963213375,khentee,0,0,0,0,0,43,[],[]
1946964534,cvicki45,0,0,0,0,0,3,[],[]
49793110,tomsherwood,32,1,6,26,1,27747,[],[]
340868467,ClavaryBud,0,0,0,0,0,34,[],[]
761151538916098048,fieldofregard,0,0,0,0,0,26,[],[]
97742111,MJK1602,1,0,1,0,0,130,[],[]
888471248778412037,JoeHaz123,1,0,0,1,1,1643,[],[]
71124776,alanrmui,0,1,0,0,0,22,[],[]
1575692791,TedHood16,74,10,16,58,6,6504,[],[]
29385331,mjensen9l,0,0,0,0,0,273,[],[]
385788216,petiadowney,3,0,2,1,0,122,[],[]
35022195,BuddyWinston,123,10,14,109,2,19449,[],[]
84249378,acIIive,1,0,0,1,0,207,[],[]
19256123,car54man,0,0,0,0,0,109,[],[]
1146896015519358977,dicey631,2,0,0,2,0,2944,[],[]
703379906,johnlharris,0,0,0,0,0,150,[],[]
82421796,Sefirosu200x,0,1,0,0,0,335,[],[]
46282778,k_slaughter,4,0,0,4,0,77,[],[]
975346338341715973,Mabeltooted,0,0,0,0,0,2188,[],[]
1063648789,DesabeV,0,0,0,0,0,344,[],[]
18335393,smarish,1,0,0,1,0,253,[],[]
54677680,SnarkAttackk,0,0,0,0,0,3809,[],[]
3393758559,Realmendontkill,0,0,0,0,0,8,[],[]
2463897895,EileenGemmell,2,1,0,2,0,180,[],[]
493372686,DonBooth2,0,0,0,0,0,49,[],[]
215726400,mosimu,0,0,0,0,0,3,[],[]
65747107,parkstorm,5,1,0,5,0,1547,[],[]
351260120,DCampoamor,20,3,2,18,0,14342,[],[]
994197651406106624,TudorDixon,51,5,17,34,2,27045,[],[]
1319492463392923649,youtwit66292907,1,0,0,1,0,0,[],[]
52906302,silverncopper,4,0,1,3,0,14286,[],[]
819705499541237760,HotPocketBandit,3,0,0,3,0,340,[],[]
249322252,DJMikeWalter,4,0,0,4,0,1520,[],[]
928597470497726467,151Odysseus,1,0,0,1,0,110,[],[]
1865937402,Volcanogranny,0,0,0,0,0,27,[],[]
22073767,rjpalumbo24,0,0,0,0,0,197,[],[]
20700991,James_Briddon,3,0,0,3,0,850,[],[]
215867282,nuency25,0,1,0,0,0,213,[],[]
627011727,Treasure530,10,1,2,8,1,802,[],[]
280302989,nicholas_mello,0,0,0,0,0,21,[],[]
1344597626122084353,Michael73591538,0,0,0,0,0,0,[],[]
121467964,monnj6,40,5,11,29,3,60669,[],[]
988828158479732737,John_Beckham14,7,0,0,7,0,2136,[],[]
210719663,MichaelRinker,0,0,0,0,0,564,[],[]
933504336079962112,RoyDove5,1,0,0,1,0,383,[],[]
1264713918,TexasTRepublic,0,0,0,0,0,1987,[],[]
40000323,glendemers,0,0,0,0,0,126,[],[]
991419164303810560,lizcitrona,3,0,0,3,0,63,[],[]
832957875290984449,HoneeDesigner,24,1,8,16,0,3610,[],[]
16373780,Leftdescending,1,0,0,1,0,752,[],[]
1340992947324645382,aasusays,0,0,0,0,0,1,[],[]
20274272,Squeaky1369,1,0,0,1,0,144,[],[]
28622119,apwriter,1,0,0,1,0,4768,[],[]
51436923,LHGuin,0,0,0,0,0,394,[],[]
2638429071,BrianByrley,1,0,0,1,0,158,[],[]
2497324297,FLady37m,0,0,0,0,0,1359,[],[]
770879618,erica4ou,0,0,0,0,0,2420,[],[]
539100892,TeivoTeivainen,12,1,2,10,0,17251,[],[]
955876980922241024,John52184723,0,0,0,0,0,39,[],[]
1026508523277111298,fox_rescue,0,0,0,0,0,97,[],[]
1337119484344201218,TayDaley,1,0,0,1,0,110,[],[]
27860907,adampowley,9,1,1,8,0,2923,[],[]
1567779126,jasonhill5371,0,0,0,0,0,42,[],[]
1041421132664979456,The_Truth_Pill,0,1,0,0,0,617,[],[]
754416690,deLIBERnATION,4,0,1,3,1,4916,[],[]
1339828628926980096,Mcdonald77M,1,1,0,1,0,548,[],[]
1220191105796493313,ZeusCannonBen,1,0,0,1,0,91,[],[]
214183053,KoolaidOath,1,0,0,1,0,746,[],[]
18377410,williamsskinner,9,1,2,7,0,2896,[],[]
397108549,AmirPazFuchs,2,0,0,2,0,416,[],[]
317068207,iamjeangrey,9,3,0,9,0,3196,[],[]
1968686180,WadeAlanGayle,0,1,0,0,0,16,[],[]
2769055911,scott28929670,1,0,0,1,0,1155,[],[]
1133158637646561281,Sydneyck2,0,0,0,0,0,1,[],[]
710533385035386880,thom_carroll,188,4,60,128,2,3206,[],[]
14251225,jheil,2148,95,176,1972,7,426461,[],[]
3353398453,MJHughes5,0,0,0,0,0,2646,[],[]
64555393,ShortyyKat_x3,0,0,0,0,0,3595,[],[]
1331692135503060998,BEKIND91125917,0,0,0,0,0,4,[],[]
136090402,valley_lover,0,0,0,0,0,93,[],[]
1087002903859077126,AndySmi50387849,5,2,0,5,1,4234,[],[]
720539445456420864,JudahTheHammer,12,2,1,11,0,594,[],[]
1268761403046985729,TheFalseWoke,0,0,0,0,0,78,[],[]
49217681,EMTHeaded,1,0,0,1,0,124,[],[]
1080280674,KimRuxton,77,9,17,60,2,27259,[],[]
817540278,1962Greta,2,1,0,2,1,4345,[],[]
1226525377595662342,MadHatt25200013,0,0,0,0,0,13,[],[]
1029047922,SweetieWalker,41,5,4,37,2,4243,[],[]
34404045,babare,0,0,0,0,0,33,[],[]
2515939392,vaderisthuis,0,0,0,0,0,160,[],[]
15701850,MartinSulkanen,0,0,0,0,0,70,[],[]
2270955728,MikeWander68,0,0,0,0,0,180,[],[]
171281306,bluenotes77,3,0,0,3,1,13600,[],[]
79249863,t_a_pierce,3,1,0,3,0,2940,[],[]
976927777,Swast90024,0,0,0,0,0,13,[],[]
398435953,tenaciousrb,1,0,0,1,0,192,[],[]
1053173766782472192,Lawson702,0,0,0,0,0,19,[],[]
749497920,nessa1909,4,1,0,4,0,1981,[],[]
1336308035480776705,Charles34630240,0,0,0,0,0,3,[],[]
348730147,BtrflyEfectTwtr,0,0,0,0,0,1066,[],[]
47429047,locust9,4,1,0,4,0,26052,[],[]
957204242439331840,MoriaMarmalade,6,4,0,6,0,2087,[],[]
16419838,slomotionwalter,0,0,0,0,0,285,[],[]
4924986593,slaytergirl,0,0,0,0,0,170,[],[]
2302362158,deanofdublin,213,3,67,146,6,13643,[],[]
1280227253926887425,LiamJeffries3,0,1,0,0,0,47,[],[]
805473146186952704,ChrisSaintau,0,0,0,0,0,730,[],[]
69291563,hmd455,0,0,0,0,0,539,[],[]
1007758791029547009,DericksKay,0,0,0,0,0,2,[],[]
979628066,MicheleOlsonm3,4,1,0,4,1,790,[],[]
1033311725054058496,motsepematlala,1,1,0,1,0,378,[],[]
2162737112,HowardKnob,7,0,0,7,0,562,[],[]
284235296,_travis2323,1,0,0,1,0,304,[],[]
23191652,saintangelo,1,1,0,1,0,1555,[],[]
1129587013517234178,OlivviaDay,27,4,10,17,1,5414,[],[]
1318563489796005895,Eric48526845,0,0,0,0,0,1,[],[]
28639777,rolyatkcinmai,10,1,0,10,0,1129,[],[]
1294443889210916866,Anasty0214,18,1,3,15,1,4061,[],[]
3121770595,franklyspoken7,0,0,0,0,0,45,[],[]
1047045793142718464,LanceACharlesS1,0,1,0,0,0,24,[],[]
824292756352888833,BlstrsOnMyFngrz,1,0,0,1,0,475,[],[]
818231848849604612,marthambrassil,1,0,0,1,0,629,[],[]
2361469350,meynrias,0,0,0,0,0,22,[],[]
1005502927,chickiebabe2u,3,0,0,3,0,3524,[],[]
3369110187,carterentinc,0,1,0,0,0,196,[],[]
4714249107,tennismobes,0,1,0,0,0,328,[],[]
33886863,stauche53,4,0,1,3,1,21939,[],[]
25975008,James_Danek,0,0,0,0,0,46,[],[]
4704062288,freedomusa27,0,0,0,0,0,1093,[],[]
584453926,KevinHarley5,4,0,2,2,0,4483,[],[]
1852878338,rodzmariel31,2,1,1,1,0,48,[],[]
3368032828,_G_r_e_g__,7,1,3,4,0,903,[],[]
23095188,Purplepetal,1,0,0,1,0,826,[],[]
1116130059008512000,Markontheradio2,4,1,0,4,0,5308,[],[]
1076728614601789440,SiriusBShaman,197,5,21,176,4,78038,[],[]
2740708156,2bvegan,1,0,0,1,0,890,[],[]
853156081165520898,tk12456,0,0,0,0,0,81,[],[]
802367392189849600,KatherineKaldis,4,0,2,2,0,1474,[],[]
1058143268247138305,Erugo8,11,0,5,6,0,3041,[],[]
846237206725353472,ohhh_david,14,2,2,12,0,2826,[],[]
981040302273085440,1_paulrigney,0,0,0,0,0,0,[],[]
91945118,le_pout,0,0,0,0,0,1742,[],[]
1112858738526842880,WARONWASHINGTON,1,0,0,1,0,488,[],[]
821836877330317312,lmatthewwl,1,0,0,1,0,59,[],[]
16342612,khar73,1,0,0,1,0,366,[],[]
235839823,HerschelWalker,19629,742,3890,15739,411,604263,[],[]
1243267124837191682,penguin_stick,0,0,0,0,0,3,[],[]
1181909259224784896,piperraynee,2,0,0,2,0,55,[],[]
1239153573327515652,PegLulu2,174,19,28,146,1,32904,[],[]
524008927,Soproudofsarah,1,0,0,1,0,458,[],[]
743742497331961856,TaliesinEvitel,798,58,7,791,0,54081,[],[]
1191471954,muycolocho,0,0,0,0,0,89,[],[]
1266339267057528833,FakeLameMedia,1,1,0,1,0,8,[],[]
1208608058974318592,WinnipegLandsc1,0,0,0,0,0,39,[],[]
544568261,starhistorian,2,0,0,2,0,3721,[],[]
1284188012780367873,RealAgent53,0,0,0,0,0,55,[],[]
437988227,MtnkatKim,0,0,0,0,0,277,[],[]
22821663,Riccaby,7,1,0,7,0,500,[],[]
222310673,hazmatnz,2,1,0,2,0,1891,[],[]
48568247,ZeliaLH,0,0,0,0,0,561,[],[]
333560942,Lady_Tweet007,0,0,0,0,0,274,[],[]
22212406,gloriouslytic,2,0,0,2,0,2423,[],[]
1284942642082652166,Fernand10142353,2,0,0,2,0,262,[],[]
1041105389683658754,RossR3232,5,0,0,5,0,10659,[],[]
21952255,GaryCiesla,0,0,0,0,0,12,[],[]
1260210845365284867,bledsoe_wes,2,1,1,1,0,44,[],[]
25675305,CorinnePulitzer,0,0,0,0,0,1445,[],[]
1187750498146902016,mozzambeacon,2,0,0,2,0,164,[],[]
1201377619712913408,gertrudemcfuzz_,12,0,0,12,0,392,[],[]
521112927,alliwoowho,0,0,0,0,0,3546,[],[]
708118382193676289,ChipSpencer1,0,0,0,0,0,247,[],[]
955847311225184259,MDonthnier,1,0,0,1,0,25,[],[]
80034110,ShadMoarif,0,0,0,0,0,944,[],[]
553188253,CruzaComplex,1,0,0,1,0,91,[],[]
43802574,eddgimenez,0,0,0,0,0,1624,[],[]
461738443,itsmorganariel,7,2,0,7,0,695,[],[]
37257359,nessasauce,2,2,0,2,0,101,[],[]
131201772,excuseyou77,1,0,0,1,0,1967,[],[]
3229433650,weatherspoonro1,0,0,0,0,0,10,[],[]
102280803,sarc3n,1,0,0,1,0,11,[],[]
381703082,DermotKeyes,9,0,0,9,0,9362,[],[]
396272143,thewestwingTV,74,0,4,70,1,20211,[],[]
46074725,3To3,5,1,0,5,0,3281,[],[]
1259023339600789506,Ray10559660,0,0,0,0,0,3,[],[]
900110843903438850,bigNewman,0,0,0,0,0,186,[],[]
518265117,rettes05,0,0,0,0,1,90,[],[]
1344310228347662336,LeoWill71788908,0,0,0,0,0,80,[],[]
708469711411908608,TeHenderson14,0,0,0,0,0,2287,[],[]
1075262950229843968,DogsNDemocrats,11,2,1,10,0,6424,[],[]
824738978251235329,Mareesani,0,0,0,0,0,327,[],[]
707035770259955713,mytruckmonkey,0,0,0,0,0,3521,[],[]
24005500,divisionbyzero,8,0,2,6,0,868,[],[]
299017753,Big_lundi,2,1,0,2,0,365,[],[]
855631659370020864,ShannonWBell,0,0,0,0,0,27,[],[]
183380667,sdclewell,1,0,0,1,0,217,[],[]
1099854776559456256,ShawnTheRuiner,0,0,0,0,0,359,[],[]
283774837,kmuneebhassan,0,0,0,0,0,92,[],[]
39022579,Grotiantwit,0,0,0,0,0,12,[],[]
3113593248,papavart,2,0,0,2,0,178,[],[]
250885899,PamelaBwell,1,0,0,1,0,3023,[],[]
935970603802259458,aliasann79,1,0,0,1,0,2566,[],[]
888515417194602502,Flyntloch,7,4,3,4,0,80,[],[]
1030920248642297856,45bestwords,13,1,2,11,0,7715,[],[]
1308428893481820161,TSAllen7,0,0,0,0,0,18,[],[]
16616782,ericlewis,0,0,0,0,0,10866,[],[]
983330634,jimlohmar,17,1,1,16,0,1764,[],[]
17526738,sf_ultra,0,0,0,0,0,103,[],[]
41940890,HBwriterMike,21,3,9,12,2,9748,[],[]
29894847,kylegrantham,0,0,0,0,0,1417,[],[]
14322472,asbestos,1,0,0,1,1,896,[],[]
2516041476,oddballwoofwoof,3,0,0,3,0,232,[],[]
2413165070,DominosCustomer,4,0,0,4,0,221,[],[]
499116075,khalidaljufairi,3,2,0,3,0,375,[],[]
774099067349573632,Yeow777,0,0,0,0,0,277,[],[]
25029390,iheartauthority,7,0,2,5,0,19994,[],[]
1268547316329394177,HowardWerten,11,2,3,8,0,1079,[],[]
1022705084,snocochixmom,0,0,0,0,0,17,[],[]
17181227,AmericaHostage,0,0,0,0,0,98,[],[]
1248781062513319936,Suzanne69703297,5,0,2,3,0,684,[],[]
803034377680777216,stevesinishtaj,0,1,0,0,0,373,[],[]
2927958798,glenzee79,0,0,0,0,0,215,[],[]
291518861,michaeltotka,0,0,0,0,0,280,[],[]
48514553,gedalyahreback,3,0,0,3,0,1195,[],[]
1506005306,keithnico1,1,1,0,1,0,134,[],[]
103438769,jmnpub,47,1,8,39,0,456,[],[]
1101561128,grodaeu,10,1,0,10,0,3714,[],[]
1308687467411730433,times_worst,3,0,1,2,0,5,[],[]
1298706559191613441,CivileSermo,0,0,0,0,0,925,[],[]
139683363,Zayd_Depaor,0,1,0,0,0,55,[],[]
2401878902,dederoghut,0,0,0,0,0,8,[],[]
16881384,alfredwebre,11,1,3,8,3,5772,[],[]
1194200564554485760,YusufAliSAN_NG,4,1,2,2,0,54,[],[]
329071217,tanissue,5,1,1,4,0,2814,[],[]
1120903989183168512,travisresists,0,0,0,0,0,254,[],[]
22804865,trcfwtt,30,3,6,24,0,20918,[],[]
124898913,Truthbuster,8,0,3,5,0,12338,[],[]
48163539,crichardson_tx,0,0,0,0,0,706,[],[]
825717050538618880,timolarch,108,0,12,96,1,24224,[],[]
1287297891615244291,RShackleford17Q,0,1,0,0,0,142,[],[]
970930627079000065,MidKnightBlue_,1,0,0,1,0,140,[],[]
41425790,MilesSolay,16,0,4,12,0,1759,[],[]
1310720304453386245,JamesRacer5,0,0,0,0,0,0,[],[]
793141686989795328,Claytonross_,0,0,0,0,0,119,[],[]
1063280402977173504,wyrick_matt,0,0,0,0,0,373,[],[]
832994080749678592,jackson210575,0,0,0,0,0,2,[],[]
777581201968082945,TruAmericanPat,27,0,9,18,0,8180,[],[]
40603286,Nepa45,0,0,0,0,0,398,[],[]
239049185,kathylew2001,3,0,0,3,0,2108,[],[]
72318928,AdamSpenner,1,0,0,1,0,68,[],[]
29056641,JasonMeadors,7,0,0,7,0,173,[],[]
2546356310,mattpmurph,60,2,13,47,1,16704,[],[]
22406338,megbiddle,1,0,0,1,0,82,[],[]
826545719100071936,Desertrain63,0,0,0,0,0,300,[],[]
1158503497693913088,motherofdobes,0,0,0,0,0,63,[],[]
601497998,chrismknapp,0,0,0,0,0,169,[],[]
18296892,sbrews,1,0,0,1,0,35,[],[]
1034122190,4shade17,1,0,0,1,0,2440,[],[]
3582086477,prevostscifi,12,2,2,10,1,1612,[],[]
1089591168,thans933,0,0,0,0,0,170,[],[]
52603141,mwulfeck,0,0,0,0,0,1025,[],[]
2202445327,DaveDomina,10,0,3,7,0,5027,[],[]
965992281043062784,Prosperous1776,467,63,161,306,37,26776,[],[]
1339959497872306180,BuffBadger,0,0,0,0,0,16,[],[]
351346086,AmericaFightHim,158,16,36,122,7,13733,[],[]
925412348956782592,JaniceC51908547,1,0,0,1,0,9,[],[]
558180233,mdnij34,115,18,11,104,3,59834,[],[]
1413104335,BillTzamaras,256,13,56,200,2,14149,[],[]
161373775,ckg33,3,1,0,3,0,186,[],[]
3157990219,ARIZONAPICS,0,0,0,0,0,179,[],[]
1211708370912038912,Atheist_Globe,3,1,0,3,0,6921,[],[]
1320939242910969856,Sycophantcat,0,0,0,0,0,9,[],[]
3008169697,fbjshope,1,0,0,1,0,632,[],[]
1119768842698416133,probably_rob,10,1,0,10,0,348,[],[]
8863042,PinataEconomics,0,0,0,0,0,7,[],[]
251682185,BlitztheDragon,2,0,0,2,0,270,[],[]
204641350,frohnonamf,2,0,1,1,0,302,[],[]
2196508730,MAWoodlandLady,8,0,1,7,0,3412,[],[]
1321464199185375234,DorothySixx,1,0,0,1,0,62,[],[]
821977266263642112,Emi_A_5,10,3,0,10,0,2636,[],[]
1174076979953504257,Loboenski,1,1,0,1,0,1106,[],[]
37375233,StevenXPR,0,1,0,0,0,1849,[],[]
282885127,SunuKay,1,0,0,1,0,211,[],[]
753937212,arthur_boone,0,0,0,0,0,171,[],[]
1381782889,AwareMap,3,1,1,2,1,1638,[],[]
1210045828301283329,VickieJGilliam1,0,0,0,0,0,3288,[],[]
17272619,Runningactor,1,0,0,1,0,997,[],[]
1260733552817319942,chris_mcinnish,1,2,0,1,0,663,[],[]
16787838,nealrogers,183,12,10,173,1,30155,[],[]
1295012821705601024,oHSoIcoNic1,1,1,0,1,0,49,[],[]
2913132048,neophrasis,0,0,0,0,0,28,[],[]
1251492751293775872,donald_soto00,0,0,0,0,0,17,[],[]
3901554934,sgtmolly06,0,0,0,0,0,897,[],[]
19926319,JennyDLatimer,2,0,0,2,0,514,[],[]
1244468233639346176,WaitingForRona,2,1,0,2,0,1141,[],[]
2502718783,CheezusIsTheOne,5,1,0,5,0,39,[],[]
1345467828359585792,Dan83491,0,0,0,0,0,0,[],[]
22984770,IntlMergers,0,1,0,0,0,3363,[],[]
77296598,ImaniAmil,1,0,0,1,0,1812,[],[]
2610339679,JustLetMeFinish,0,0,0,0,0,274,[],[]
500271052,MalcolmMorton1,2,0,0,2,0,824,[],[]
525686932,LawrenceTStimso,0,0,0,0,0,535,[],[]
22445710,kargobus,1,0,1,0,0,35,[],[]
515793752,dannymassey21,1,0,0,1,0,13,[],[]
2900189221,AlphaFemale_Pac,1,0,0,1,0,3239,[],[]
1162165116437008385,KJNO816,0,0,0,0,0,7722,[],[]
31192615,LinzMarie3,1,1,0,1,0,1153,[],[]
1241374843255377923,Michael58952829,1,1,0,1,0,0,[],[]
1553835727,BastienBlonde,9,1,3,6,0,848,[],[]
116446117,Oh_Hedda_Hopper,0,0,0,0,0,111,[],[]
1286050667992248320,SoundsTruthful,12,1,2,10,1,2325,[],[]
2820722533,PLabarbiera,0,0,0,0,0,30,[],[]
1160683341110099968,saulgooodmann,0,2,0,0,0,121,[],[]
1321368191709446144,SpeakingSatan,46,5,1,45,0,13516,[],[]
1317518913832439809,monirenadjafli4,0,0,0,0,0,136,[],[]
435463947,WoodyePhillips,0,0,0,0,0,45,[],[]
1297346271619870721,mcclante,0,0,0,0,0,6,[],[]
57947126,unexpectedrev,4,0,0,4,1,180,[],[]
1119936598479638530,DRichardH1,0,0,0,0,0,2632,[],[]
477987833,N_Like_Flint,0,0,0,0,1,60,[],[]
1018514689096069122,GaryB12515175,4,0,2,2,0,268,[],[]
22895219,Tymills,2,0,0,2,0,149,[],[]
1303094400063549440,mno_eric,0,1,0,0,0,1,[],[]
53388429,skyco_g,5,0,2,3,0,3349,[],[]
1316632697104674816,TeslaWiggleswo1,0,0,0,0,0,2,[],[]
38877250,ecthompsonmd,4,1,0,4,0,1419,[],[]
1344850438445805569,ThinkOtter,0,0,0,0,0,1,[],[]
314887220,jschaf01,0,1,0,0,0,513,[],[]
611543307,BuyingAir,5,0,1,4,0,1148,[],[]
2907368164,SusanStroupe,0,0,0,0,0,96,[],[]
795788956176617472,MoonliteLeper,0,0,0,0,0,309,[],[]
1277575127639736320,HornLoud,0,1,0,0,0,110,[],[]
61617248,HaHaJamezJonez,0,0,0,0,0,106,[],[]
977954172556361733,kathrynresister,2231,147,390,1841,45,48625,[],[]
827072741304004609,JTMcGinley,0,0,0,0,0,367,[],[]
1079911819303477248,James01432028,0,0,0,0,0,4,[],[]
21900039,SDaviesLaird,1,0,0,1,0,1004,[],[]
4647632599,ssgtwrightusmc,1,0,0,1,0,1405,[],[]
63987387,josephochambers,3,1,0,3,0,749,[],[]
1372668180,MichaelGarofola,39,3,2,37,0,22938,[],[]
88853677,nevzKe,1,0,0,1,0,839,[],[]
846918905012482048,PoliticalCarol1,2,0,1,1,0,269,[],[]
859240384219807744,jaredlfnelson,4,1,1,3,0,111,[],[]
94333081,CairoTiger,4,0,0,4,0,464,[],[]
1289228669530112007,Vca09300789,0,0,0,0,0,8,[],[]
164796804,Ojaijeni,0,0,0,0,0,51,[],[]
1115377685147062273,20PearlGirl57,2,0,1,1,0,4113,[],[]
284389328,PaddyDoubleMs,1,0,0,1,0,362,[],[]
540385402,lovely_wifey77,1,0,0,1,0,60,[],[]
19788392,MaryLunde,0,0,0,0,0,321,[],[]
251869493,Hoffstowe,1,0,0,1,0,110,[],[]
24965373,todd_allen,3,0,0,3,0,610,[],[]
958916273060175872,JasmineForHD108,298,6,59,239,8,9269,[],[]
437681879,AskCisco,3,0,1,2,0,783,[],[]
724522566,sarahglloyd12,0,0,0,0,0,136,[],[]
886602670416343040,burnmyaccountv,1,0,0,1,0,110,[],[]
2394025881,Dianayeisley,3,1,0,3,0,137,[],[]
1017532516310192129,livingthedreem1,0,0,0,0,0,2265,[],[]
46024803,MBilalY,0,0,0,0,0,633,[],[]
1339365280187822080,WeebWriterz,0,1,0,0,0,41,[],[]
433760083,noirpaien,0,2,0,0,1,95,[],[]
2894033826,tjloy,0,0,0,0,0,43,[],[]
3087003308,_KianaRJ,3,0,1,2,0,1605,[],[]
53088091,DrewKnightWV,14,1,2,12,0,2255,[],[]
1233399566642356224,GeorgeS52925878,0,0,0,0,0,0,[],[]
39228858,AcePikorito,5,0,0,5,0,394,[],[]
271464960,AnnScott5252,1,0,1,0,1,854,[],[]
6411962,lilianedwards,7,3,1,6,0,8297,[],[]
17468420,graddietude,2,0,0,2,0,536,[],[]
1289269044462473217,CodeBus75199556,0,0,0,0,0,0,[],[]
1293214608254275586,RM_Patriot,0,0,0,0,0,457,[],[]
65700868,WINDSONG58,3,0,1,2,0,3735,[],[]
1284937318865031180,realmlee2,23,3,6,17,3,6434,[],[]
773736691,jentiphansen,7,0,1,6,0,2358,[],[]
2388042907,christina_bobb,7367,331,825,6542,108,186235,[],[]
1155582533137883136,Tina43967841,0,0,0,0,0,0,[],[]
28407870,kevinkoperski,2,0,0,2,0,1608,[],[]
67720265,cjamesms,0,0,0,0,0,178,[],[]
366943003,KellyScaletta,227,3,50,177,3,24750,[],[]
871121035151630336,AdamGrouping,2,0,1,1,0,37,[],[]
871589598387949568,LoveLight5D,11,4,3,8,0,1296,[],[]
1329611411664871424,John_Anti_Trump,12,3,1,11,0,17694,[],[]
64555920,thomloverro,132,10,3,129,0,18240,[],[]
16175064,LScribbens,0,0,0,0,0,1062,[],[]
1263246686568112128,MamaNikki2007,6,1,0,6,0,1015,[],[]
759424266647502848,mika_edmondson,541,6,77,464,4,22681,[],[]
2408272447,taotdev,0,0,0,0,0,3,[],[]
1284134377073541121,RyanAllisonNC,1,0,0,1,0,57,[],[]
41549120,RabidScotsman,0,0,0,0,0,75,[],[]
784575415457308672,TheRealHoarse,11518,79,1666,9852,60,408300,[],[]
2874807761,ArthurVallejomd,12,1,5,7,0,1034,[],[]
1047962604403154946,Nofaithinhuman2,0,0,0,0,0,277,[],[]
1482156662,BestNashTransit,4,1,2,2,0,1237,[],[]
120287565,colliersays,0,0,0,0,0,143,[],[]
88076743,celeste2247,11,3,3,8,0,61,[],[]
912516934960214018,A_UribeFINZ4ME,0,0,0,0,0,214,[],[]
1272853504571379713,TrumpDogsfor,2,0,1,1,0,251,[],[]
1340540038723948544,maeinlvnv2,0,0,0,0,0,9,[],[]
1264710365948063744,ThabusyBee,3,0,0,3,0,343,[],[]
2890103754,WontMarch4Soros,0,0,0,0,0,2338,[],[]
3063933906,davidchapman141,5325,218,1073,4252,150,12832,[],[]
1336350322936131584,PedoBiden4,1,1,0,1,0,2,[],[]
1482454333,aqua_tella,1,0,0,1,0,123,[],[]
1280209571391459335,paulaaronfisher,2,0,0,2,0,77,[],[]
4913509866,ButGod365,0,0,0,0,0,163,[],[]
59574144,MWM4444,0,0,0,0,0,2585,[],[]
1260691020401893376,DickSmithy,0,0,0,0,0,50,[],[]
1119036023760216064,HowardW4710,1,0,0,1,0,73,[],[]
714450600,BlandBoyd,1,1,0,1,0,73,[],[]
146898990,DanielSteckler,0,0,0,0,0,46,[],[]
22595418,scarymay,1,0,0,1,0,796,[],[]
168908585,mrnickgriffin,0,0,0,0,0,221,[],[]
95982892,BlackGoose94,1,2,0,1,0,873,[],[]
1306327626819211270,RaisedRightShow,1,0,0,1,0,59,[],[]
305832118,slims_jc,0,0,0,0,0,125,[],[]
1334108528764600324,TimesRuth,6,0,3,3,1,42,[],[]
18552104,Drowz,0,0,0,0,0,3746,[],[]
1182120675965714432,JohntheChecker,2,1,0,2,0,13,[],[]
79104155,keldajean,1,0,0,1,0,51,[],[]
2168732150,Coogcheese,2,0,0,2,0,446,[],[]
3131775527,ggman2015,0,0,0,0,0,4,[],[]
27860174,SWEETCASUNSHINE,0,0,0,0,0,422,[],[]
853265052048257024,PJohnsonBrown1,8,1,2,6,0,468,[],[]
979634575,johngerickson,0,0,0,0,0,29,[],[]
799326923142770688,AnneElizabethUS,53187,2103,10631,42556,580,18016,[],[]
1326915290349907968,VirginiaGeline4,2,1,1,1,1,40,[],[]
1289045526336303104,PorcuLivio,0,0,0,0,0,23,[],[]
2994052382,Edyb0123,1,0,0,1,0,29,[],[]
498348514,_214949559669,0,0,0,0,0,6,[],[]
2352289351,ChipCarpentry,0,0,0,0,0,424,[],[]
29817779,Freedom2Fascism,0,0,0,0,0,123,[],[]
1263897378953838592,JimmyForrester6,0,1,0,0,0,26,[],[]
1062299463765487616,USALovinPatriot,0,0,0,0,0,117,[],[]
15841568,Non_GMO_Gringo,55,4,13,42,7,1630,[],[]
1856385247,tsvph1,16,1,3,13,0,3144,[],[]
165335229,2111015,11,0,4,7,0,3806,[],[]
1161481444780367873,sinheathen,0,0,0,0,0,19,[],[]
25233049,kwaters2008,3,0,0,3,0,3226,[],[]
2901726347,Colette_NYC,3,1,1,2,0,2667,[],[]
730739351047573504,pipkin56056003,0,0,0,0,0,490,[],[]
41599062,stherdman,0,0,0,0,0,328,[],[]
371086068,Jonnybgbold,23,1,0,23,1,1328,[],[]
801190004,MEvans57,1,0,0,1,0,3933,[],[]
399712913,ten24get,4,2,2,2,1,5997,[],[]
1306802150786428928,Myfathe26794918,0,0,0,0,0,3,[],[]
589407608,RockyMntnMike,42,2,6,36,0,22684,[],[]
496374828,domedog311,16,4,6,10,3,697,[],[]
78210089,clj59,2,0,0,2,1,295,[],[]
1284115235742330880,DbsRabbi,0,0,0,0,0,2,[],[]
834445238416584705,mikewtfwells,98,3,16,82,0,2828,[],[]
1047021,brainsmatter,0,0,0,0,0,1737,[],[]
1345677102662742016,GoebbelsParody,0,0,0,0,0,1,[],[]
1328240307033477121,mikeratcliffe19,1,0,0,1,0,55,[],[]
744931381487165440,harleyquinnical,1,0,0,1,0,1037,[],[]
142566997,FOberly,4,1,0,4,0,308,[],[]
1127730132859457536,Genia32397201,0,0,0,0,0,9,[],[]
1106515000045305856,canyoubelievet5,2,0,0,2,0,2093,[],[]
1290801756499259398,jillymcneely,1,1,0,1,0,188,[],[]
246035604,TheAlexNevil,34,1,8,26,0,35162,[],[]
23101100,elysekm,0,0,0,0,0,11,[],[]
432734907,jwlarrabee,939,17,215,724,13,29173,[],[]
1539301,dobbs,0,0,0,0,0,81,[],[]
16344329,MrFarmahini,1892,9,105,1787,0,87000,[],[]
1157143663,SweetFnLucifer,1543,29,334,1209,27,150810,[],[]
828667827624280064,afitzhughe,2,1,0,2,0,11370,[],[]
133536086,ActuallySar,19,1,2,17,0,667,[],[]
1315025645664112640,VanDaManDFS1776,0,0,0,0,0,165,[],[]
733342066457989120,ethannfoxx,4,1,1,3,0,235,[],[]
1273032968819191808,MoberlyPamela,0,0,0,0,0,1266,[],[]
49822735,BenC1357,4,0,0,4,0,1074,[],[]
362149323,panich52,1,0,0,1,0,2664,[],[]
2290551968,TNPats,0,0,0,0,0,506,[],[]
1223019473466208256,LeoHunt78789567,1,0,0,1,0,33,[],[]
393858940,AaronMcCright,1,0,0,1,0,535,[],[]
996355228638351362,Joy17123083,10,2,2,8,0,510,[],[]
1407461,ssharwood,4,1,1,3,0,5812,[],[]
530813732,pemersonvb111,0,0,0,0,0,1070,[],[]
1148065432563154945,docal68,1,0,0,1,0,1481,[],[]
392211677,Jock_Dock,2,0,1,1,0,674,[],[]
1206973835511312386,DotSoop,0,0,0,0,0,222,[],[]
17669628,iamsharpe,12,2,2,10,0,5749,[],[]
815364772317184000,67jewelCDH,122,8,16,106,0,18244,[],[]
1273079138199330816,lml19801,0,0,0,0,0,3,[],[]
15212751,CeSpeaks,0,0,0,0,0,497,[],[]
1003140983922409472,Nikita_KAG,2,0,1,1,0,2404,[],[]
1151173212148916224,DaveEmeraldCity,0,0,0,0,0,12,[],[]
74796241,Retardicans,0,1,0,0,0,317,[],[]
1082454357445099520,Josh78416203,0,0,0,0,0,3,[],[]
795282059514249216,ozengin22,7,2,1,6,0,8721,[],[]
1025274127383494656,joe_norte,137,28,29,108,7,5852,[],[]
19023662,vnick9775,13,3,5,8,0,218,[],[]
1325633974274723840,IAStateCRs,3,0,0,3,1,66,[],[]
1327307673923010560,BeerAplenty,0,0,0,0,0,53,[],[]
329908550,danni_j5,0,0,0,0,0,95,[],[]
1045779367106949121,VictoriaVogt5,4,1,2,2,0,8552,[],[]
1089014209159913473,JonHoll19737915,0,1,0,0,0,31,[],[]
15834599,padresj,151,14,12,139,2,40897,[],[]
359213808,technotaco31,2,0,0,2,0,410,[],[]
1120690717054128128,UneditedView,22,5,8,14,0,3442,[],[]
409597601,GHVMtnFever,0,0,0,0,0,389,[],[]
279716634,Pamela_Gardner,0,0,0,0,0,378,[],[]
620598571,Cheffsky44,0,0,0,0,0,9,[],[]
1267075441,Cha51brolll19,18,3,0,18,0,16436,[],[]
268691233,realtrashbandit,1,0,0,1,0,93,[],[]
827239533733433345,FDLives,3,0,0,3,0,94,[],[]
1264284011821781002,eyefull1,0,0,0,0,0,77,[],[]
17670827,AlanBaxter,27,2,1,26,0,15940,[],[]
1355258971,ElBeeBexar,0,0,0,0,0,0,[],[]
2614813098,NorisDiDi,4,0,0,4,0,2657,[],[]
236022435,BreastfeedingNY,3,0,0,3,0,5793,[],[]
4206284351,grassnotes,0,0,0,0,0,37,[],[]
2493728726,flomukiri,0,0,0,0,0,76,[],[]
415776636,Comanche980x,0,0,0,0,0,4412,[],[]
1496584674,TheSlyWolfy,2,1,1,1,0,355,[],[]
3420085095,SovMichael,63,0,9,54,0,22549,[],[]
1221571759851409408,JeremyC39436224,0,0,0,0,0,67,[],[]
2775963721,ContingencyFee,79,0,7,72,0,9996,[],[]
35406205,MichaelHattem,81,0,5,76,1,9653,[],[]
22103003,RealAaronHarvey,0,1,0,0,0,207,[],[]
458774277,BenZuehlke,0,0,0,0,0,22,[],[]
364523275,Littlebear334,0,0,0,0,0,54,[],[]
4361653577,k8ryners,0,0,0,0,0,3125,[],[]
14304302,nwjerseyliz,1,0,0,1,0,11852,[],[]
1275467088136736771,RdSull,0,0,0,0,0,283,[],[]
344633710,PsychicHealerC,55,2,18,37,2,148791,[],[]
419138015,kamariebostic,0,0,0,0,0,120,[],[]
4079361561,hiwassee_river,4,0,0,4,0,56,[],[]
1103484940837019648,galenmaskin,0,0,0,0,0,109,[],[]
1240308408227594243,hcrc_ga,2,0,1,1,0,514,[],[]
2555880805,sbaaronson,0,0,0,0,0,301,[],[]
330022225,OuttaCa,1,1,0,1,0,862,[],[]
1331726536190291969,2TheBarricades,3,2,0,3,1,9208,[],[]
734216509,EsPyramid,16,0,3,13,0,875,[],[]
111490382,HeyJudeOregon,0,0,0,0,0,3621,[],[]
205070160,TylerRoaix,1,0,0,1,0,320,[],[]
145091095,davidwappel,6,1,0,6,0,8558,[],[]
759981194213724160,allenrgee,1,1,0,1,0,1356,[],[]
1268250301661921281,pourquoiparlens,0,0,0,0,0,108,[],[]
15846993,MJPattersonTN,1,0,0,1,0,699,[],[]
4173743139,buffalo_wallow,1,0,0,1,0,160,[],[]
981515528404484096,By_Grace_saved1,0,0,0,0,0,4435,[],[]
45284563,BiomedicalDude,2,0,1,1,0,592,[],[]
1203749575678255104,DaviidLuke,0,1,0,0,0,54,[],[]
21207491,liberalgoddess,258,36,32,226,3,19565,[],[]
408240205,Dr_Rick_N,0,0,0,0,0,172,[],[]
1160154876166512641,alfieri_tom,1,0,0,1,0,2,[],[]
260106537,jahan_tyson,0,0,0,0,0,4397,[],[]
2723399552,amymeansjustice,2,0,2,0,0,290,[],[]
459553008,RipODouglas,0,0,0,0,0,4,[],[]
1281739679763779585,DanielKurle,15,2,0,15,0,4042,[],[]
1217406588534841344,Rico_Suave9595,1,0,0,1,0,388,[],[]
45649898,doubleg392,0,0,0,0,0,224,[],[]
8494612,AdamWallenta,6,0,1,5,0,14029,[],[]
777802487466168320,Saysyeswecan,0,0,0,0,0,1241,[],[]
34962136,Collinoscopy,1,0,0,1,0,424,[],[]
1211396526104137728,ShannonSykora,0,0,0,0,0,7,[],[]
1039941071734808577,lajansen3,0,0,0,0,0,0,[],[]
16537813,yuzumanu,15,3,1,14,0,2815,[],[]
1002381676687872002,MarkieJP,20,0,2,18,0,16517,[],[]
705459483368099841,Armory_Gaming,0,0,0,0,0,288,[],[]
1162465044820443136,Rev2119,0,0,0,0,0,0,[],[]
816789845490049024,Rtn4452Randy,4,0,1,3,0,14086,[],[]
72812437,umfood,0,0,0,0,0,5,[],[]
202653831,bichonsandabc,0,0,0,0,0,363,[],[]
437141293,TrophyCatas,1,0,0,1,0,11737,[],[]
21584887,PortCityPisces,0,0,0,0,0,1817,[],[]
804746800536186880,MabelKirke,0,0,0,0,0,37,[],[]
794743643919814659,OperativeXRay,54,2,8,46,1,5300,[],[]
4846465932,ReelRepublican,0,0,0,0,0,37,[],[]
16854125,notarealmatthew,0,0,0,0,0,289,[],[]
1112440996216733696,cfost2,3,0,0,3,0,164,[],[]
1938807884,Denman516,0,0,0,0,0,405,[],[]
48601215,McGurran71,0,0,0,0,0,65,[],[]
770186418,epigeotweedle_d,2,0,0,2,0,158,[],[]
195977495,TylerDierking,0,1,0,0,0,286,[],[]
1225687543296905217,GreatImpeach,1,1,0,1,1,4355,[],[]
2180418909,theskybuscus,0,0,0,0,0,116,[],[]
4782843697,86jenniferjones,5,2,0,5,0,221,[],[]
760116445435101184,scribbler011,1,0,0,1,0,9,[],[]
768068805675319298,A_Candle_Lit,1,0,0,1,0,2566,[],[]
746442561884033025,Strat6120,0,0,0,0,0,62,[],[]
3221923010,zipadeedoodah2,0,0,0,0,1,143,[],[]
1323576878247088129,JontTrubek,46,7,12,34,2,22015,[],[]
36489765,TomNow,3,0,0,3,0,301,[],[]
301417751,pjsandiegosdca,1,0,0,1,0,1907,[],[]
733589953,BrianKeithReed,0,1,0,0,0,42,[],[]
1320194011689308160,jqrm17,2,0,0,2,0,207,[],[]
785915038162792448,CStreetlights,5,1,1,4,0,2229,[],[]
1243674808128278529,Martii063,1,0,0,1,0,642,[],[]
1280153354551930880,QPastorPatriot,0,0,0,0,0,7,[],[]
269574838,MoomjyN,3,0,1,2,0,10094,[],[]
771061537712836609,Bahbahlewi,0,0,0,0,0,481,[],[]
2984781465,elihbeckman,53,2,12,41,1,12947,[],[]
968907124423131137,KennethDolney,1,0,0,1,0,120,[],[]
848518471,SnarkAmendment,2,0,0,2,0,4915,[],[]
35854737,LemaAbeng,1,0,0,1,0,3069,[],[]
4421497221,emily_zorro,11,0,0,11,0,803,[],[]
37303214,a______rr,1,1,0,1,0,342,[],[]
113076492,daraalt,1,0,0,1,0,1799,[],[]
1441650062,inthevelvet,0,0,0,0,0,50,[],[]
284721271,mimiharris56,9,1,3,6,0,529,[],[]
4764702082,azizisasis,0,0,0,0,0,61,[],[]
1365480481,CrazyCommonCens,1,0,1,0,0,1740,[],[]
4095233806,lemming_last,2,0,1,1,0,612,[],[]
1122358856896536577,TheBabeLincoln,3,0,0,3,0,4,[],[]
283327937,chiquibon2,19,9,4,15,1,16357,[],[]
17618459,kingRio,2,0,1,1,0,363,[],[]
738121668829274112,securingdev,4,1,0,4,0,2378,[],[]
21144764,TheMace,1,0,0,1,0,465,[],[]
1106896133635391489,Maxss114,0,0,0,0,0,4,[],[]
2295604701,daliaggeorge,2,0,1,1,0,2607,[],[]
184842367,MFAngeleeta,0,0,0,0,0,478,[],[]
34945366,danaroach,57,4,3,54,1,5294,[],[]
263765550,KernNuts,8,0,0,8,0,346,[],[]
1100984259098132481,chic0demayo,4,0,1,3,0,46,[],[]
85159774,fdprocomp,0,0,0,0,0,112,[],[]
1228305374052175873,Ejalu1,0,0,0,0,0,83,[],[]
348158426,CommittoVote,7,1,2,5,0,1205,[],[]
898311931454525440,McCokeHead,0,0,0,0,0,36,[],[]
965694944567611394,BeingJWood,264,14,43,221,5,41763,[],[]
197220694,DCHI23,204,16,11,193,0,3998,[],[]
1151640183781175306,Mpaou812,0,0,0,0,0,48,[],[]
1275523010305290240,tonyindrag,0,1,0,0,0,16,[],[]
2771098852,kim_maximilian,0,0,0,0,0,11,[],[]
260303901,DrewFrogger,4,1,0,4,0,13513,[],[]
260255567,DirectHostility,0,0,0,0,0,447,[],[]
885883632,AnOUTFITforYOU,0,0,0,0,0,339,[],[]
460721178,Bette__Davis,5,0,1,4,0,433,[],[]
64861129,angieinmiami,21,0,5,16,0,127,[],[]
1330356446,TinaLayne77,1,0,0,1,0,1958,[],[]
2608740770,PeterWMurphy1,75,2,16,59,1,13608,[],[]
65580597,RandomAlaskan,14,2,0,14,0,1497,[],[]
21806425,mckneely,0,0,0,0,0,130,[],[]
1320180127284776961,VPerkins77,0,0,0,0,0,394,[],[]
772948822347673601,7675376666rhon,0,0,0,0,0,1236,[],[]
115959970,douginbrooklyn,0,0,0,0,0,91,[],[]
1318324241088073728,FranckV7,0,0,0,0,0,0,[],[]
16391314,gregsmithsays,0,0,0,0,0,612,[],[]
16139470,lemonton,0,0,0,0,0,12353,[],[]
1118978055949684748,Nabru72118710,0,1,0,0,0,522,[],[]
1272831480507494401,DingCVelasco,2,1,0,2,0,168,[],[]
1279547630280998914,raguillemette,0,0,0,0,0,9,[],[]
936038790346493952,Euthyphraud,1,0,0,1,0,478,[],[]
370119780,degnerforiowa,5,0,0,5,0,718,[],[]
15068897,effingalan,1,0,0,1,0,1355,[],[]
349419581,scorpiofred747,25,0,8,17,0,21777,[],[]
891091330566426624,KCAddison68,16,2,5,11,0,18303,[],[]
35341081,rsen01,0,2,0,0,0,1184,[],[]
1237499222171308033,J_R_Belanger,3,1,1,2,0,766,[],[]
286717773,lowguppy,0,0,0,0,0,622,[],[]
1054867839268474880,Reality9991,4,0,1,3,1,1,[],[]
772055978,Ms_Xtina,3,0,0,3,0,3988,[],[]
307212554,AlexVickeryHowe,7,1,0,7,0,3852,[],[]
775885352477265920,DaleKanzler,3,4,0,3,0,23673,[],[]
1929057074,SarahNye5,4,0,1,3,0,107,[],[]
60692031,AlanGSwope,0,0,0,0,0,25,[],[]
1060967641962016768,ruggiere_l,67,6,25,42,1,12594,[],[]
1055845522106400769,Gmichelle1970,0,1,0,0,0,120,[],[]
2800581040,BillKristol,53329,1169,6773,46556,384,986038,[],[]
258981961,_jackerman_,0,0,0,0,0,84,[],[]
1345501458704248839,CRice77621963,0,0,0,0,0,2,[],[]
568698899,Lori_McCormick,1,1,0,1,0,151,[],[]
1265308772291031042,MarkKinnamon,0,0,0,0,0,1,[],[]
390813451,eliaskottayam1,1,0,0,1,0,23,[],[]
25978997,Brieezy_F_Baby,0,0,0,0,0,404,[],[]
3290965291,bmadaity,2,0,1,1,0,6,[],[]
21519512,Herronisland,1,0,0,1,0,11285,[],[]
28244830,realSharonFred,0,0,0,0,0,158,[],[]
59007356,Katohi808,1,0,0,1,0,4,[],[]
24469245,quangerst,0,0,0,0,0,201,[],[]
71693621,timneeson,2,0,0,2,0,1437,[],[]
964983794112630785,sheepdogsamurai,0,0,0,0,0,130,[],[]
19361778,jevidal,0,0,0,0,0,170,[],[]
308946662,Dani1987C,0,1,0,0,0,1402,[],[]
33091632,exsailor62,0,0,0,0,0,4038,[],[]
116791981,fadojoe,0,0,0,0,0,662,[],[]
851944976409874433,microtome45,8,0,2,6,0,26385,[],[]
46283994,sugerkat,0,0,0,0,0,832,[],[]
202890215,AuntyOtter,2,0,1,1,0,972,[],[]
753605383,518CardsFan,1,0,0,1,0,66,[],[]
1070872842118541313,AReckoningDay,0,0,0,0,0,136,[],[]
399129934,LightfootInHwd,37,4,12,25,0,2472,[],[]
270089764,DanTambini,0,0,0,0,0,11,[],[]
72309372,jayrod_CA,0,0,0,0,0,159,[],[]
1177945200431370240,Rubicon1313,63,1,10,53,1,38760,[],[]
1288516522953117696,WiseWillis2,0,0,0,0,0,0,[],[]
1280239922985779206,DeppermannTerry,1,0,0,1,0,2069,[],[]
18458953,nuke718,0,0,0,0,0,693,[],[]
300070242,perlygatekeeper,2,0,0,2,0,167,[],[]
24022998,purpleH2Oski,0,0,0,0,0,475,[],[]
822868576600211457,danamarena,9,0,1,8,0,2685,[],[]
3328688975,Fanofjays,0,0,0,0,0,3531,[],[]
79252262,punkpoodle22,0,0,0,0,0,1636,[],[]
1898959950,pfenomenologist,8,1,1,7,0,3032,[],[]
294241090,Heeltoeatt,3,0,1,2,0,41,[],[]
3177200475,JoymcdMcdonald,0,0,0,0,0,709,[],[]
110846839,JoaoBoscoJardim,0,0,0,0,0,826,[],[]
16432028,tomabernathy,5,0,0,5,0,3600,[],[]
1243654518782308352,TheMerc25459952,3,0,1,2,0,1840,[],[]
1229999131051151361,stewartj0421,2,0,0,2,0,22,[],[]
40271429,NoLiberals,1,0,0,1,0,1874,[],[]
1336763007347662855,empathicpolitic,9,1,4,5,0,1698,[],[]
3242532865,KyleGarnerMO,8,0,2,6,0,2074,[],[]
43700533,DoctorWarmflash,0,0,0,0,0,1355,[],[]
285676185,DC_DeWitt,6,1,1,5,0,3596,[],[]
744269927595577344,paytreearch,1,1,0,1,0,130,[],[]
1321679268926038016,jonatha69274525,0,0,0,0,0,5,[],[]
2699334156,Antoniota2T,0,0,0,0,0,47,[],[]
838548303646076928,thsu7001,3,0,0,3,0,5,[],[]
1094251238021984256,genxstan,6,2,0,6,0,993,[],[]
1332866076204429312,emaloy24,0,0,0,0,0,11,[],[]
583656268,robertschueller,0,0,0,0,0,334,[],[]
799415368577974272,gamergate2077,307,19,14,293,1,3986,[],[]
760271818502443008,PJLELECTRIC,1,0,0,1,0,42,[],[]
1324213380941447168,elainemdenison1,0,0,0,0,0,31,[],[]
139229024,TBPInvictus,26,1,5,21,2,9971,[],[]
373975228,ml8_ml8,2,1,1,1,0,1020,[],[]
896516878214074369,Frank60566087,0,0,0,0,0,25,[],[]
66140805,Qaos_Qitty,0,0,0,0,0,228,[],[]
1316890905119395840,MarySco49655844,0,1,0,0,0,0,[],[]
552084514,AlibumD,0,0,0,0,0,3857,[],[]
16163715,SynRen,1,0,0,1,0,163,[],[]
516831505,MilkZaddy1,1,0,0,1,0,497,[],[]
878263474631069697,jc20170623wil,0,0,0,0,0,199,[],[]
15190312,aderra,2,0,0,2,0,3564,[],[]
635660190,daniel_kurz,1,0,0,1,0,1643,[],[]
2402397650,usa_in_beijing,83,9,13,70,1,14923,[],[]
2218461564,Ed_Baptist,74,0,10,64,0,8472,[],[]
261005543,Harmonov,2,1,0,2,0,431,[],[]
3026976474,PassableGhost,0,0,0,0,0,392,[],[]
139526681,missfayejones,0,0,0,0,0,4,[],[]
986999945868824576,BrookeGDesign,26,2,5,21,0,612,[],[]
955488275967299584,imaginarymaniac,0,0,0,0,0,2847,[],[]
9480572,JLCBamberger,3,0,0,3,1,10175,[],[]
394747413,sensen2011,8,1,1,7,0,2423,[],[]
62302766,at_howard,0,1,0,0,0,1542,[],[]
420557183,JosephKnoop,14,3,0,14,0,2182,[],[]
738390173650681857,nati_nielle,0,0,0,0,0,1044,[],[]
84957890,NickHanauer,288,31,23,265,8,53009,[],[]
102029710,markbotsford,4,0,1,3,0,215,[],[]
1108362870763347969,barbarryber,7,0,2,5,1,357,[],[]
302884468,GerardMulligan1,8,0,1,7,0,6673,[],[]
19469391,roarrrbecca,6,2,1,5,0,482,[],[]
2944711772,printsallday,0,0,0,0,0,19,[],[]
3390449433,gdinkneh,0,1,0,0,0,248,[],[]
710574966337576960,FelipeJortiz2,0,0,0,0,0,19,[],[]
942628154,JojoWestModel,4,0,0,4,0,722,[],[]
1252591030236524552,BeautyWholly,0,0,0,0,0,15,[],[]
176556196,danbeers,44,0,2,42,0,461,[],[]
741778686345519104,IS3088624269,0,1,0,0,0,366,[],[]
1214930024379363329,Janik_Blue,13,0,3,10,1,912,[],[]
2163597692,Hbobrow1Hbobrow,403,29,83,320,9,55667,[],[]
2835412194,Bluntteh,0,0,0,0,0,203,[],[]
823041299372773381,JeremyA441981,0,0,0,0,0,102,[],[]
3278758339,GeekTexas,0,0,0,0,0,1153,[],[]
18437976,MantaMay,4,0,0,4,0,1040,[],[]
1197480690046193664,HerIRL_TC,1,0,0,1,0,873,[],[]
1107368728566599681,MegaMAGAMaggie,1895,123,281,1614,75,2470,[],[]
496582121,BlueTidalWave,9,0,2,7,0,12066,[],[]
12575342,babbles,0,0,0,0,0,658,[],[]
21132805,_ChristopherM,33,1,6,27,0,4369,[],[]
1059918117651013638,tammy386803,0,0,0,0,0,4,[],[]
470916711,jmewayne,1,0,0,1,0,544,[],[]
317612354,praywice,0,0,0,0,0,883,[],[]
77042130,stacemobile,0,0,0,0,0,189,[],[]
259384771,AverageJer,8,2,0,8,0,1375,[],[]
21897722,writebrainedny,0,0,0,0,0,13736,[],[]
1082347171444416512,JunoMcduff,2,0,0,2,0,39,[],[]
22039951,marginoferror,5,0,0,5,0,776,[],[]
901980066627940352,MapleRedC,0,0,0,0,0,84,[],[]
349206084,cruisegirl56,0,0,0,0,0,109,[],[]
58486635,thehrgenius,0,0,0,0,0,151,[],[]
1268243347275165698,SteamboatLion,0,0,0,0,0,127,[],[]
1226706237229879296,MaddysMom4209,0,1,0,0,0,124,[],[]
144684845,Chugarz,5,3,1,4,1,778,[],[]
1268272384710021120,TDubsGoonSquad,0,0,0,0,0,717,[],[]
437043250,RyanClarkWZR,0,0,0,0,0,3214,[],[]
1345486023351021568,Johncha59671342,0,0,0,0,0,3,[],[]
123640968,AmericaRising17,4,1,1,3,0,6823,[],[]
782244756592193538,SayThisMrTrump,0,1,0,0,0,495,[],[]
386001751,KT_So_It_Goes,1075,16,139,936,1,76040,[],[]
1150433767279828993,KiniKa1mi,2,0,1,1,0,3062,[],[]
14483330,chrissaid,0,0,0,0,0,273,[],[]
