User ID,User Name,Node_weight,Reply Count,Retweet count,Like Count,Quote Count,Followers Count,FOllowerID,Follower name
589441034,Jord1856,11,0,0,11,0,407,[],[]
1062207410897608704,lilly_astro,0,0,0,0,0,2,[],[]
417467685,BalachanderKris,0,0,0,0,0,58,[],[]
46594943,Belshelzar,0,0,0,0,0,177,[],[]
1015084941498048513,POTUS_15,11,0,3,8,0,3047,[],[]
1595857231,ZonaMMABJJ,0,0,0,0,0,271,[],[]
21328006,Davidlaz,1120,86,159,961,19,25662,[],[]
816440614967476224,vera_louise8622,0,1,0,0,0,19,[],[]
1272719172976259074,glock_mama,70,9,6,64,1,4192,[],[]
1324571175956156416,DennyRichards7,0,0,0,0,0,7,[],[]
762148519750668288,theladenswallow,0,0,0,0,0,30,[],[]
1333695204881264640,Mr_Pierson317,0,0,0,0,0,33,[],[]
333385009,JustJoshinYu,0,0,0,0,1,399,[],[]
67142652,TwFBCW,0,0,0,0,0,1478,[],[]
49223147,rdking647,0,0,0,0,0,125,[],[]
241721501,MaroonedInMarin,3,0,1,2,0,1941,[],[]
1064304991,ArsonRenllaw,3,0,0,3,0,7027,[],[]
1077650659757895680,RogerRossberg,0,0,0,0,0,7,[],[]
29585629,Josh_Moon,980,49,184,796,22,25727,[],[]
131066395,GodIsDead,7,0,3,4,0,839,[],[]
812363924,areidross,166,8,19,147,5,13309,[],[]
2726723111,Justice03549592,0,0,0,0,0,290,[],[]
491566968,RyanLink4,0,1,0,0,0,168,[],[]
521782324,rascal_sage,0,0,0,0,0,75,[],[]
191550474,Hokieman78,20,0,5,15,0,129,[],[]
1325236606673035265,Metacrisis2,0,0,0,0,0,6,[],[]
755513,nfinitefreetime,2,0,1,1,0,10435,[],[]
709428667085148161,honestbroker2,0,0,0,0,0,204,[],[]
2822939337,LucyFurTweets,11,1,0,11,0,3580,[],[]
1001478636543926273,OhZoinksScoob,0,1,0,0,0,171,[],[]
930178296,ArmandoNDK,36,0,9,27,0,14750,[],[]
780554655159898112,Dolphin_Tj34698,2,0,1,1,0,5162,[],[]
847080140098207746,elder_jodi,8,1,1,7,0,19723,[],[]
3259084400,Lainyw619,0,0,0,0,0,24,[],[]
1361914580,grimmrad,2,0,0,2,0,1795,[],[]
16313174,babystew,3,1,0,3,0,2104,[],[]
17562032,KenOplinger,1,0,0,1,0,342,[],[]
24582559,hotchef9,6,3,0,6,0,775,[],[]
729128598133714945,DEI1117,1,0,0,1,0,1145,[],[]
1119260981090291712,NatetheLawyer,99,18,11,88,1,22822,[],[]
1936463258,xenopraxis,1,0,0,1,0,2936,[],[]
62620340,usmcwifemom,0,1,0,0,0,1642,[],[]
55712853,PapaTob,0,1,0,0,0,86,[],[]
151186162,LikeAGoodIdea88,0,0,0,0,0,952,[],[]
812914642066341888,goldilockstrump,3,0,0,3,0,1961,[],[]
47098430,TimMavTv,5,1,1,4,0,435,[],[]
377987330,johnalogue,4,0,1,3,0,10915,[],[]
1310740706449817604,ChurchJim1,0,0,0,0,0,30,[],[]
1084355081074544641,deveshgupta97,0,0,0,0,0,185,[],[]
340292810,padrehoboken,0,0,0,0,0,379,[],[]
1293920254276644864,FreedomInc5,0,1,0,0,0,9550,[],[]
1671213210,CarolynHogarth,0,0,0,0,0,30,[],[]
891660610655498240,lkalydoy,0,1,0,0,0,5,[],[]
149642576,techshady,0,0,0,0,0,157,[],[]
1184559507504095233,djhutch74,744,84,124,620,7,5687,[],[]
1103744060194463744,FocusLacks,2,0,1,1,0,1274,[],[]
1123063045142376448,WillHarrisAOAF,33,8,2,31,0,31683,[],[]
1318915229124800512,EatsMao,2,0,0,2,0,663,[],[]
247113015,refull67,3,0,1,2,0,124,[],[]
23046474,salarta,1,1,0,1,0,855,[],[]
766091830563835904,dian_simplethin,1,0,0,1,0,12371,[],[]
3419257222,plainjane5555,12,2,1,11,1,4353,[],[]
3244465746,TheFaxMatter,129,7,24,105,4,41473,[],[]
2736564757,tashiscash,3,0,0,3,0,137,[],[]
4644975693,DanielFourteen,0,0,0,0,0,121,[],[]
1315453244211109890,mayorsealy,0,0,0,0,0,32,[],[]
90480410,nhoutexusa,0,0,0,0,0,11,[],[]
25571567,kathrynhorsman,0,0,0,0,0,1203,[],[]
1038092730,shame0360,0,0,0,0,0,86,[],[]
1312214788148097024,realjoshbowen,6,2,1,5,0,143,[],[]
3190898215,SassyOrganicGal,0,0,0,0,0,11,[],[]
523635534,PeterVenskus,0,0,0,0,0,35,[],[]
1324513358842859520,Kirk75339953,1,0,0,1,0,3,[],[]
191071575,CorchIrvinMeyer,1,0,0,1,0,125,[],[]
725018196,crossofcrimson,0,0,0,0,0,272,[],[]
215207998,kurteichenwald,19858,381,4217,15641,239,512653,[],[]
1932158635,rick_casey,0,0,0,0,0,284,[],[]
21684595,jaysbookman,68,2,14,54,0,20019,[],[]
25681108,RealAngelaKaye,2,1,0,2,1,1979,[],[]
27766802,cmadin,1,0,0,1,0,69,[],[]
1022631666,LuceResists,0,0,0,0,0,10270,[],[]
33232323,kevinkate,0,0,0,0,0,35,[],[]
1316493909376237569,SonNatura,0,0,0,0,0,6,[],[]
28394717,skeeva,11,1,1,10,0,6455,[],[]
1568713968,perry3220,5,0,0,5,0,882,[],[]
1345779530238021632,KevinFetty2,0,0,0,0,0,0,[],[]
1312110385705738241,KatieJ220,0,0,0,0,0,38,[],[]
3959989991,dloydfaulk,1,0,1,0,0,1610,[],[]
1345778990229958656,Stormy64275311,0,1,0,0,0,3,[],[]
2664250388,mjclover12,3,0,1,2,0,2979,[],[]
97112775,waynejpan,0,0,0,0,0,291,[],[]
139895694,ANGIE_nyc,1,0,0,1,0,526,[],[]
18210896,JohnTole,1,0,0,1,0,4967,[],[]
334421439,jeffwontshutup,0,0,0,0,0,245,[],[]
373687309,RunnerWest,1,0,0,1,0,973,[],[]
1067968702400876544,american2084,8026,696,1294,6732,233,114179,[],[]
819029878003630081,KSue2759,0,0,0,0,0,1621,[],[]
726167841611890692,DixieStanick,0,0,0,0,0,82,[],[]
1314731727420612615,VT_theGoodLife,0,0,0,0,0,319,[],[]
1295746284855480321,SeanSki0,0,0,0,0,0,20,[],[]
419759137,JDSharp1,1,0,0,1,0,23,[],[]
624664727,drewhuntre,1,1,0,1,0,3100,[],[]
18986377,alexdgrossman,4,0,0,4,0,953,[],[]
2766862088,_Jrlh_,35,2,6,29,1,3048,[],[]
201469741,DawnGoodsell,0,0,0,0,0,2032,[],[]
25168054,livieeexoo,1,0,0,1,0,130,[],[]
1249002732058443777,stiffRIGHT,2,2,0,2,0,1029,[],[]
1244255762685349888,kryhavoc2,0,0,0,0,0,1039,[],[]
2764521078,HolycitySaleem,7,0,1,6,0,669,[],[]
9228192,DemYellow,2,0,0,2,0,3136,[],[]
1216492899979804673,DirectNewsComm,3,0,1,2,0,315,[],[]
825687259739361280,Priscil57967280,0,0,0,0,0,8,[],[]
4892544645,Stornoway_Cove,54,2,15,39,1,57766,[],[]
20473318,jus10p,12,1,0,12,0,1936,[],[]
901629119342903297,moe_abdella,0,0,0,0,0,74,[],[]
229401301,jonnyredjive,1,0,0,1,0,402,[],[]
1065291624501133313,sherry_sangel,1,0,0,1,0,293,[],[]
35468643,jdougmar,4,0,1,3,0,939,[],[]
20850566,GordonMcClendon,65,5,5,60,1,20424,[],[]
1065103915358797824,klose_terry,0,0,0,0,0,81,[],[]
716750760734822400,vespertilioAJR,1846,58,389,1457,27,27486,[],[]
939098012751503360,kamal_fazal,0,0,0,0,0,1107,[],[]
732779507506020352,Ms_Erika74,80,4,20,60,3,23332,[],[]
2837792129,AimingHigher11,14,1,2,12,0,17173,[],[]
19077081,anguspodgorney,0,0,0,0,0,403,[],[]
4490169614,GranddadSpencer,1,0,0,1,0,44,[],[]
454050379,harrysty1eslvr,6,0,0,6,0,347,[],[]
716688050,MrErnestOwens,38,6,5,33,0,32735,[],[]
1338796515419168769,TrumpDogsPolice,3,0,0,3,0,2245,[],[]
1249800587643744256,Royfran9,0,0,0,0,0,489,[],[]
54192022,JettaJack,0,0,0,0,0,23,[],[]
263939051,TheMotel_3,0,0,0,0,0,873,[],[]
891036965402943488,SassyKadiK,5770,182,1142,4628,106,53669,[],[]
1229076830541504512,JeffKnightJr,0,0,0,0,0,0,[],[]
1154880593274056706,dgafwabgtsam,2,1,0,2,0,118,[],[]
979192194144899074,MyMagnifOctopus,8,1,1,7,0,587,[],[]
253630850,k9BIS,0,0,0,0,0,5,[],[]
63996778,joegooding,70,2,16,54,1,41737,[],[]
937930411077963777,Mateo_in_ATX,0,0,0,0,0,761,[],[]
730558426053521408,EirolSivad,2,0,1,1,0,655,[],[]
1044482679008317440,toni_barretto,0,0,0,0,0,0,[],[]
799287737388072960,kat2020maga,10,0,5,5,2,14193,[],[]
339282789,SueCrean,1,1,0,1,0,305,[],[]
1341796764328738816,AMaestrx,0,0,0,0,0,2,[],[]
1707369648,MediaBuzzFNC,36,88,8,28,4,17959,[],[]
16305686,billhousley,0,0,0,0,0,168,[],[]
1046824683163852800,bs_spare,17,0,3,14,0,3354,[],[]
940409602155282432,FogCityMidge,3014,280,396,2618,84,127115,[],[]
55564704,atoherbert,0,0,0,0,0,245,[],[]
1023276809155108865,leafar13098102,0,0,0,0,0,114,[],[]
940359770330025984,wanca101,0,0,0,0,0,2,[],[]
1303142119771713536,Matthew15980620,2,0,0,2,0,26,[],[]
825923261829517312,THISISAMERICA46,0,0,0,0,0,7,[],[]
1220526224142934016,LEERandy8,2,0,1,1,0,10,[],[]
972258945019596800,mykareno2,1,0,1,0,0,3279,[],[]
1246097987501199365,ChrisLois2,0,0,0,0,0,84,[],[]
878763702840938496,david_pylant,2,1,0,2,0,2597,[],[]
1145870115772104704,RecoveringInAZ,2,1,0,2,0,187,[],[]
1577865295,Flutterbygypsy,2,0,0,2,1,1698,[],[]
825573340253450244,DanaWindowman56,1,0,1,0,0,1547,[],[]
2411937883,ThatcherAStone,0,0,0,0,0,46,[],[]
1237088678,LosTrains,0,0,0,0,0,195,[],[]
731201212624801794,nelson041609,0,0,0,0,0,10,[],[]
1252967454432620547,KenMorr62214189,0,0,0,0,0,146,[],[]
1312713386539524096,Cline2471,0,0,0,0,0,6,[],[]
100535517,flimflamsammy,0,0,0,0,0,96,[],[]
108708410,Artzthings,3,0,1,2,0,16427,[],[]
2460027617,f0xym0ron,1,1,0,1,0,346,[],[]
1270479918942638086,KarenMc45141424,3,0,1,2,0,2776,[],[]
1325529651511373824,peekoil00,20,1,6,14,2,1406,[],[]
885418392,ripologist,10,1,0,10,0,732,[],[]
115100051,EMC_Lady,0,1,0,0,1,38,[],[]
981669197133615104,BillPegs,20,2,2,18,0,5947,[],[]
808826086591262727,OC86370976,0,2,0,0,0,82,[],[]
20742778,jaimesommers,0,0,0,0,0,26,[],[]
20278830,ghelt,17,5,1,16,0,4927,[],[]
1223645279657897991,DCampbe45532185,1,0,0,1,0,0,[],[]
3313420169,Colonel_Craz,0,0,0,0,0,21,[],[]
79402536,Bo_73,1,0,0,1,0,171,[],[]
792014441525239809,AverageJoeBe,0,0,0,0,0,1360,[],[]
2675543232,ericlahti1,14,2,0,14,0,22757,[],[]
20269680,surlyZ,7,0,1,6,0,2472,[],[]
2404078428,BarbFrericks,2,0,0,2,0,704,[],[]
1959980840,pmarkwheeler,0,0,0,0,0,124,[],[]
1126936577588883457,expertadviserss,0,0,0,0,0,33,[],[]
426660412,dave_newby,6,1,0,6,0,2927,[],[]
818461278297587712,NETraveller2017,0,0,0,0,0,0,[],[]
1148749109697765376,BunnyLu59314170,0,0,0,0,0,92,[],[]
992125244029759488,Frank68158859,0,0,0,0,0,240,[],[]
749633597879889920,140_West,4,0,2,2,0,280,[],[]
368673071,AriCohn,109,7,6,103,1,26806,[],[]
111213985,gabenix1,1,0,0,1,0,145,[],[]
867519339699748864,replicantPOTUS,0,0,0,0,0,20,[],[]
472072778,TOAM77,0,0,0,0,0,20,[],[]
2746699247,sunnyparty01,1,0,0,1,0,6,[],[]
1221868779556286465,MDoran132,0,0,0,0,0,21,[],[]
971086622551953408,SkidmoreDebbie,0,0,0,0,0,0,[],[]
12412802,jlq529,0,1,0,0,0,3283,[],[]
71032451,JoeCerone,2,1,0,2,0,43,[],[]
755946560794558464,amvetsupport,4857,165,1058,3799,94,99038,[],[]
1263217405863645188,GetsTim,0,0,0,0,0,8,[],[]
1191176344006283266,RefRgby,0,0,0,0,0,249,[],[]
620525532,jasonedemarco,0,0,0,0,0,103,[],[]
264577303,TheHappyHodler,1,0,0,1,0,143,[],[]
1327666564292808704,Hoop220,0,0,0,0,0,0,[],[]
51500289,LJLanham,5,2,0,5,0,780,[],[]
225684809,LorraineDWilke,22,4,3,19,0,9014,[],[]
3257722140,ketan_sarkar_,26,0,2,24,0,4259,[],[]
17202571,Talikka,2,0,1,1,0,1289,[],[]
69032477,dkbgeek,0,0,0,0,0,245,[],[]
1199457545850458113,FritzSchmukmire,0,0,0,0,0,419,[],[]
26262458,WriterJCYoung,2,0,0,2,0,1286,[],[]
1635473161,StuartTart,0,0,0,0,0,150,[],[]
480741630,skis416,11,0,4,7,1,3054,[],[]
900739794912903168,TheRepublic2021,2,1,1,1,0,4679,[],[]
1275993580478164992,GenuineRight,12,0,6,6,1,4,[],[]
869560550174334976,SharonT67853942,0,0,0,0,0,278,[],[]
1651225333,danielchaitin7,187,23,38,149,6,10452,[],[]
17711375,smclements,0,0,0,0,0,75,[],[]
1299500427529117697,DaveWizSr1,1,0,0,1,0,1,[],[]
1151975261904261120,Max_Gibson3,65,16,20,45,6,2883,[],[]
1293188004601831426,Bv23451353,0,0,0,0,0,1,[],[]
1275824345730949120,BellaBe63637273,0,0,0,0,0,206,[],[]
979440926,wmoreorless,2,0,1,1,2,1449,[],[]
2180184829,abnwarrant,3,1,1,2,0,1804,[],[]
1198717876649234433,Hendie7407,0,0,0,0,0,2680,[],[]
4895086852,stoneandland,0,0,0,0,0,24,[],[]
322046408,xml_jim,4,0,1,3,0,551,[],[]
1338510961804644352,idahomeagent,0,0,0,0,0,17,[],[]
3176678274,KalebMcKelvey,0,0,0,0,0,239,[],[]
292569575,numbtothepain79,0,0,0,0,0,1109,[],[]
96995590,kps67,1,0,0,1,0,425,[],[]
1329857522581319681,gerrifreed1,0,0,0,0,0,111,[],[]
813052195734192128,gracebw77,0,0,0,0,0,2291,[],[]
2169020365,wlfcamp,0,0,0,0,0,93,[],[]
36384758,lindajjacobs,0,1,0,0,0,788,[],[]
1228880064227360769,DrainTheGop,0,0,0,0,0,52,[],[]
1085717640860102656,AmericanCarey,0,0,0,0,0,343,[],[]
80710298,nievesboricua,0,0,0,0,0,49,[],[]
1202951798782337025,LXibalba,0,0,0,0,0,8,[],[]
837344043021570049,MichaelGreens12,1,1,0,1,0,3432,[],[]
3941144900,CookJustinT,0,0,0,0,0,9,[],[]
1042878102,jpsabresfan78,0,0,0,0,0,375,[],[]
29568236,kennypetrowski,4,1,0,4,0,458,[],[]
1010668246696185856,praterd42,0,0,0,0,0,1,[],[]
3048086874,Ethan_Wheeti,2,2,0,2,1,218,[],[]
1021361523589984256,InTheNoosphere,78,3,14,64,0,33376,[],[]
143280090,thegreene1,0,0,0,0,0,166,[],[]
729336970716000259,stoerRick,0,0,0,0,0,16,[],[]
1176331240632455173,Davis16Doc,1,1,0,1,0,15,[],[]
156480131,RaksinSergal,0,1,0,0,0,256,[],[]
115839509,PatronPatmos,4,1,2,2,0,581,[],[]
490328549,doehillmeme,16,0,5,11,1,3584,[],[]
1056753793,TheMSRP,0,0,0,0,0,51,[],[]
1716008431,The_Dogside,0,0,0,0,0,490,[],[]
1326530344934383622,JessWasHere1998,0,0,0,0,0,24,[],[]
15098787,ajsfour,37,3,2,35,0,4257,[],[]
2615788650,BacdocKw,0,1,0,0,0,413,[],[]
1103434202622513152,RMontanan,0,0,0,0,0,24,[],[]
40362585,joywinds,0,0,0,0,0,222,[],[]
770662687160274944,joebev49,17,0,2,15,2,1348,[],[]
26378459,AllenVHarris,1,0,0,1,0,1555,[],[]
204433926,An_American123,0,0,0,0,0,44,[],[]
1098317586645876737,KatinaDemitras,0,0,0,0,0,10,[],[]
556939347,sqsarasota,0,0,0,0,0,1365,[],[]
1309352820286656513,StvnSchimmel,0,0,0,0,0,1307,[],[]
1110685698166833152,Donald78064058,0,0,0,0,0,115,[],[]
1072482816787656705,Nobody20191,0,0,0,0,0,137,[],[]
1329068277516144641,RiverOtter17,0,0,0,0,0,616,[],[]
186857666,ana_bad3,1,0,0,1,0,257,[],[]
1083974134231490560,UncleTummyTX,1,0,0,1,0,1448,[],[]
805843704,SonyaShahan,1,0,0,1,0,56,[],[]
3146485272,SisBoomBahaha,0,0,0,0,0,1078,[],[]
8616782,Republic_Kept,2,0,0,2,0,232,[],[]
703990286381408256,CindyNeighbors,5,1,1,4,1,9046,[],[]
1081763809,AquaManMck,1,1,0,1,0,49,[],[]
238657493,UnNonSequitur,2,0,1,1,0,2325,[],[]
626447875,CJ_mcrider,0,0,0,0,0,0,[],[]
3180955782,BergWyo,0,0,0,0,0,1,[],[]
1330646094808805376,yourmothers_ass,0,0,0,0,0,6,[],[]
1275093200630198272,comley_jim,0,0,0,0,0,1,[],[]
1315767917489856515,Wilkersonkathy4,1,0,0,1,0,41,[],[]
866289164186267648,Alclarke19A,1,0,0,1,0,165,[],[]
2315988770,rml2965,3,0,1,2,0,119,[],[]
3417971074,iampaigedrexler,0,0,0,0,0,31,[],[]
704066676501946368,Cheryl_WD,3,0,0,3,0,714,[],[]
161777227,criticalWnews,0,0,0,0,0,672,[],[]
1337384548972122112,ThuanTr88534208,0,0,0,0,0,0,[],[]
458764095,GavinWince,2480,130,336,2144,81,8880,[],[]
16660454,jrankney2,0,0,0,0,0,150,[],[]
19083215,Coswalt,0,0,0,0,0,126,[],[]
253355892,bjr12777,0,0,0,0,0,1901,[],[]
395546278,SnidySenses,2,0,0,2,0,271,[],[]
18021508,thatabbeysmith,1,0,0,1,0,572,[],[]
877952592223096833,TickmeofffHays,0,0,0,0,0,270,[],[]
1227727892190089218,BunnZora,0,0,0,0,0,85,[],[]
1169043278056087553,guthrie_allan,0,0,0,0,0,3547,[],[]
1173221077960548353,RauenDad,0,0,0,0,0,2,[],[]
3382404333,myfavenews,1,0,0,1,0,678,[],[]
1110117290203332608,DebbieTheWayTo1,0,0,0,0,0,113,[],[]
517139684,trash210,1,0,0,1,0,46,[],[]
1214545480040009728,Lurk61953789,0,0,0,0,0,301,[],[]
23204438,davegj,13,1,6,7,1,3885,[],[]
823214714331287559,hasanfaizulkhan,7,0,0,7,0,10798,[],[]
1329031270446272518,BlueBos58878619,1,0,0,1,0,18,[],[]
33953022,hojoismyname,2,0,0,2,0,3555,[],[]
24946159,ProfdelaPaz,0,1,0,0,0,267,[],[]
1212693038,DuncanCecil,1,0,1,0,0,23,[],[]
233801782,autumkat,0,0,0,0,0,2445,[],[]
564091548,906Superior,0,0,0,0,0,2430,[],[]
763550089847726080,wGpyP1xANtJZrFs,0,0,0,0,0,0,[],[]
38737199,Ty_Hamby,0,0,0,0,0,19,[],[]
1151161672309993472,asthe47thPOTUS,0,1,0,0,0,53,[],[]
816277171895410689,tiredofDJT,0,0,0,0,0,6,[],[]
1072593551479975936,Wisconsin_Jen,6,2,1,5,0,1009,[],[]
25616852,raysracingworld,0,0,0,0,0,1279,[],[]
719722832788373506,jacobhester922,0,0,0,0,0,36,[],[]
32396076,Joe_Duarte,0,1,0,0,0,881,[],[]
10221,yoda,6,0,1,5,0,35829,[],[]
130839126,ScrotieMcB,4,1,0,4,0,1949,[],[]
2466167059,Triple_Bravo,8,0,1,7,0,1133,[],[]
1246577464471687179,BrettT18349489,0,0,0,0,0,27,[],[]
15973184,pennyblab,0,0,0,0,0,575,[],[]
1182973909,evelezce,7,0,0,7,0,311,[],[]
17056433,IAmSophiaNelson,1644,85,286,1358,15,81349,[],[]
1312255819,BodnarJe,0,0,0,0,0,509,[],[]
606907410,election_every,41,3,15,26,1,14938,[],[]
1324701906250403840,Carolyn05312019,3,0,1,2,1,16,[],[]
761669042675421184,SipleLeslie,0,0,0,0,0,328,[],[]
1085576742696300545,DetectiveNolan,0,0,0,0,0,1275,[],[]
2369701987,vlynott,1,0,0,1,0,270,[],[]
418312949,PsuLionInsider,4,0,0,4,0,919,[],[]
14515838,Fasttracker,0,0,0,0,0,1824,[],[]
2374088880,JeffWVarcoe,0,1,0,0,0,107,[],[]
813816896181112832,golftime9000,0,0,0,0,0,0,[],[]
1055801533525356545,ADWhittingtona2,0,0,0,0,0,4191,[],[]
274702185,ilovetexas9,2,1,1,1,0,2532,[],[]
534575464,Hettinger_Tech,3,2,1,2,0,1384,[],[]
123728545,RSweney,0,0,0,0,0,1540,[],[]
885988875524505601,Annamaegreen13,0,0,0,0,0,2266,[],[]
20577717,AlbertHoward888,2,0,0,2,0,214,[],[]
741116016961392641,glogirlnat,3,0,0,3,0,3091,[],[]
1297555060847775744,GDecastilho,1,0,0,1,0,22,[],[]
1006292794216976384,rob48468059,0,0,0,0,0,465,[],[]
464576903,Chilimom_1,0,0,0,0,0,41,[],[]
322033445,SportsNTheatre,5,0,1,4,0,542,[],[]
1316845583974293504,SuburbanWoman00,1,0,0,1,0,1234,[],[]
1155990331961282560,Galt57J,2,0,1,1,0,254,[],[]
767833060662398976,TheMFingCOO,31,3,3,28,0,13071,[],[]
768470001959305216,kfreitas888,0,0,0,0,1,104,[],[]
396879948,MichaelWitschel,5,2,0,5,0,7653,[],[]
2847456599,DixiDame,0,0,0,0,0,624,[],[]
1198491116,WeirdOwlchemy,19,3,0,19,0,2223,[],[]
1153788445980024832,ChrisCrain19,0,0,0,0,0,206,[],[]
1319439746763005958,hitta_that,3,0,1,2,0,367,[],[]
791668686084050946,Lentils4Mentals,2,0,1,1,0,3071,[],[]
1211741315920064512,ZaesADSB,1,0,0,1,0,3089,[],[]
40126750,artofstyle,0,0,0,0,0,2436,[],[]
412287766,MrsHullabaloo,6,0,0,6,0,628,[],[]
2203140122,MrJim24401,1,1,1,0,0,3,[],[]
1172875525,TomM6225,2,0,0,2,0,1499,[],[]
73717605,XanderTaylor3,0,1,0,0,0,9741,[],[]
180193889,zevin0,0,0,0,0,0,108,[],[]
1345480209978552320,jenn89024751,0,0,0,0,0,0,[],[]
765978736290304000,50grey50,1,0,1,0,0,6107,[],[]
814293883722997760,OurRepublic12,0,0,0,0,0,545,[],[]
1069044708,Will_holliday1,178,10,45,133,9,6929,[],[]
1327041414555955207,GlennHa74875222,1,0,0,1,0,21,[],[]
899781480091615232,slackernparadis,0,0,0,0,0,12,[],[]
1000419876480020480,MikeyNog,78,4,6,72,1,15006,[],[]
1155572737080868865,HGessling,0,0,0,0,0,3846,[],[]
34267967,sethwixtrom,0,0,0,0,0,138,[],[]
1932827204,RhondaEllisTX,0,0,0,0,0,555,[],[]
2789879229,gass_colleen,0,0,0,0,0,498,[],[]
25690115,ImpeachVote,2,3,1,1,0,870,[],[]
1976492348,DWhippo,0,1,0,0,0,160,[],[]
1126898900818890753,tfarmer66,0,0,0,0,0,3381,[],[]
396924510,molonlav,11,6,3,8,3,322,[],[]
1328819846361047046,AVGwoman,0,0,0,0,0,3,[],[]
1152284806371336192,Upsidasium,303,9,60,243,6,23922,[],[]
14631602,GrummanGuy,0,0,0,0,0,190,[],[]
1315844688633638912,GaryLew63538570,0,0,0,0,0,6,[],[]
23961222,ilovecutie,0,0,0,0,0,31,[],[]
341688336,HelenTuttle,40,9,12,28,5,2605,[],[]
275190051,Nupe117,53,2,17,36,4,11080,[],[]
830264389622042624,amylilbits,0,0,0,0,0,22,[],[]
1005729871,ARtweaker,0,1,0,0,0,563,[],[]
331067472,YzabettaSativa,0,0,0,0,0,1652,[],[]
321598666,deanwmarkle,0,0,0,0,0,12,[],[]
1103762809538703363,BauerHour15,16,1,0,16,0,717,[],[]
236026645,afarbstein,0,0,0,0,0,24,[],[]
792091207140716544,lawyer4laws,91,10,23,68,2,23325,[],[]
36988190,rkirchmeyer,5,0,2,3,0,17309,[],[]
1219451814,19geoff67,1,0,0,1,1,30,[],[]
3924736462,TheNaviegator,1,0,1,0,0,73,[],[]
821429675222306819,Grownassman9,5,2,0,5,0,4606,[],[]
768091774371921920,mrreedshistory,0,0,0,0,0,308,[],[]
36838847,ms_divine_diva,2,0,0,2,0,354,[],[]
2250553538,Chocolit123,0,0,0,0,0,217,[],[]
781999720684105729,HWayneStorey1,1,0,1,0,0,1122,[],[]
1287352673080160262,samaquino427,0,0,0,0,0,5,[],[]
3246115952,BodyCnts,3,0,1,2,0,24,[],[]
18648198,snarkysillysad,3,2,0,3,0,165,[],[]
471392998,patcosca,0,0,0,0,0,12,[],[]
923696319994007552,HenningfeldC,0,0,0,0,0,0,[],[]
1253386708705574912,DennisCole58,1,0,0,1,0,51,[],[]
293090523,Phaulkner,4,1,0,4,0,998,[],[]
613122792,jalexdez,0,0,0,0,0,247,[],[]
3295415432,DaDiBartolomeo,2,0,0,2,0,272,[],[]
1014248527,jennifermcfarl4,3,1,1,2,0,10550,[],[]
1285548612844433408,JMB19741,0,0,0,0,0,1,[],[]
484373948,GodsLoveHeals1,1,0,0,1,0,613,[],[]
329982125,SWAttorney,3,1,2,1,1,132,[],[]
329014427,idealistme2,0,0,0,0,0,32,[],[]
1211829937008562176,Brakinator99,4,0,2,2,0,2292,[],[]
48714828,wisejude27,1,1,0,1,0,54,[],[]
504871641,DobyTheBoxer,12,1,0,12,0,6848,[],[]
1062914186987094017,Doodlebugisblue,0,0,0,0,0,951,[],[]
1205542328473128964,biggyb97929634,0,0,0,0,0,4,[],[]
227955596,josvdvo,0,0,0,0,0,401,[],[]
1337266196371083265,AnonGoddessA,0,0,0,0,0,26,[],[]
1048240792530309120,SoNowUknow2,5,0,2,3,0,4535,[],[]
40524653,TiffanyMarie264,3,0,0,3,0,1229,[],[]
16583986,lisakauai,0,0,0,0,0,1105,[],[]
21054423,Dobblesworth,0,0,0,0,0,73,[],[]
1254730612184760320,Brajverma17,0,0,0,0,0,5,[],[]
1318495911518109696,hollowdumpling,2,0,1,1,0,474,[],[]
1208179785396043782,mackste91193615,3,0,0,3,0,1377,[],[]
1263886140744110088,RickSmi92609099,0,0,0,0,0,2,[],[]
3663180085,1minutetomidnit,38,4,8,30,0,4627,[],[]
1216158963974033408,FreedomGlobalN1,0,0,0,0,1,24,[],[]
779279170752831488,kparksnash,0,0,0,0,0,13,[],[]
294764262,RoRonDgo,82,7,22,60,2,5346,[],[]
1295129476473520133,iamwilloc,0,0,0,0,0,202,[],[]
2852368305,JohnRobGalloway,0,0,0,0,0,223,[],[]
1191223754640089090,StanReeves5,0,1,0,0,0,0,[],[]
1159605007433551873,VMA2539,1,1,1,0,0,656,[],[]
114047616,fordte,0,0,0,0,0,1,[],[]
224305976,ABeeJBee,0,0,0,0,0,400,[],[]
703646604486639617,Dillonwits,3,0,1,2,0,41,[],[]
24167929,RadunzelR,0,0,0,0,0,106,[],[]
1241893502201606145,AlmaiJeff,0,0,0,0,0,4,[],[]
1170148810636632072,FischerToy,0,0,0,0,0,61,[],[]
3754943594,Mr_Jayy_Redd,1,0,0,1,0,713,[],[]
365153182,PatriotIE,4,1,0,4,0,130,[],[]
1058293700130856961,Georgin49871365,1,1,0,1,0,34,[],[]
531481646,donal_lee,0,0,0,0,0,1040,[],[]
3161256426,jrflamingo,0,0,0,0,0,2,[],[]
304691182,sabriaballand,0,0,0,0,0,1554,[],[]
340485578,Americanoid,0,0,0,0,0,13881,[],[]
727843711602728960,dbaker71852,0,0,0,0,0,909,[],[]
625526939,NinaHelsing,0,1,0,0,0,63,[],[]
553130638,DebbySeagraves,0,0,0,0,0,259,[],[]
753009824707719168,Reluctant801,0,0,0,0,0,44,[],[]
897992587163848704,Gyaneshwar1972,0,0,0,0,0,64,[],[]
2367350779,RnbwMelodiesMom,0,0,0,0,1,355,[],[]
1245168258195419138,IamSamIam1969,9,4,4,5,0,1560,[],[]
843746270602706945,rt_villanueva,0,0,0,0,0,43,[],[]
3022762819,iAjay_Banyal,10,0,1,9,0,6151,[],[]
809873840536883200,r_goosy,1,0,1,0,0,4,[],[]
824889138973249536,Rose21172,0,0,0,0,0,253,[],[]
241326293,brendamoffitt,1,0,0,1,0,243,[],[]
1340111880447266820,Browneyes656766,0,0,0,0,0,5,[],[]
737173204213469184,SimplyWhelmed,2,2,2,0,0,116,[],[]
895345706319269889,creepdestroyer1,0,1,0,0,0,31,[],[]
1281952886600224768,Dkl77012133,2,0,0,2,0,3927,[],[]
1412645168,Tommy10390906,0,0,0,0,0,76,[],[]
827224720739336192,RealPresidentT,113,37,17,96,2,15908,[],[]
1232842069028327424,TypistsNight,2,0,1,1,0,9,[],[]
67084125,awakingnations,0,1,0,0,0,173,[],[]
1311765442206347264,ballisticfrisby,1,0,0,1,0,495,[],[]
863203478,CorkyCorkle3,10,0,3,7,0,3138,[],[]
1361868332,iccy_isak,0,0,0,0,1,2845,[],[]
2764515824,umpadvocate,6,0,1,5,0,142,[],[]
765217728739282944,sg1011sg,0,0,0,0,0,30,[],[]
14327705,civex,0,0,0,0,0,117,[],[]
47907346,tonizek,0,0,0,0,0,357,[],[]
1237191562754392067,jersey_stringer,0,0,0,0,0,31,[],[]
1325978219061735425,NoahMervine,0,0,0,0,0,117,[],[]
1344826575540289536,EndereLipehn,0,0,0,0,0,33,[],[]
29783491,Atkins_Dave,1,0,0,1,0,591,[],[]
1335470762434703360,MrMannyUSA,1,0,0,1,0,823,[],[]
1086312702262284290,Coach40057156,0,0,0,0,0,379,[],[]
3313006027,Likeshesays,485,47,98,387,20,10041,[],[]
403647413,LSVanderver,0,0,0,0,0,673,[],[]
1066775528,dawgsmack,8,0,0,8,0,3532,[],[]
1116213423266648064,whatgives1313,6214,304,1466,4748,282,65432,[],[]
34896584,joslewis,7,1,0,7,0,5630,[],[]
1344721197544722436,JeremyPyle11,0,0,0,0,0,1,[],[]
1307142013733797888,sleepypollster,4,1,0,4,0,568,[],[]
27565899,Surfingcity,132,15,39,93,12,8324,[],[]
703404427978395648,RaziloUSA,49,13,14,35,1,5084,[],[]
434626652,CarlDunnJr,8,0,1,7,0,9038,[],[]
18743921,sthomas451,0,0,0,0,0,112,[],[]
2907305821,MdAftabSaifi,0,0,0,0,0,645,[],[]
223567249,henri_Ohm,0,0,0,0,0,328,[],[]
124227565,madamepasquier,0,0,0,0,0,691,[],[]
321774180,ChrisJZullo,269,8,71,198,2,144329,[],[]
1282881631573827584,coding_tortoise,0,1,0,0,0,20,[],[]
897172016150839298,JamesChillLax,0,1,0,0,0,69,[],[]
168829030,RawMixedNuts,10,0,3,7,0,5609,[],[]
1344578966435241984,Rodrieli03,1,0,0,1,0,138,[],[]
1249438728084324352,hm8XGQEm7KmML7y,0,1,0,0,0,15,[],[]
32496409,wmonte,0,1,0,0,0,509,[],[]
3131132619,SamWilson1947,0,0,0,0,0,38,[],[]
41274526,devondavispa,0,0,0,0,0,1058,[],[]
1221997808640675841,RoadyWilliams,0,0,0,0,0,10,[],[]
42766013,Shultz_PA,3,1,1,2,0,157,[],[]
1298299807497297922,saveusculture,3,0,0,3,0,4855,[],[]
343327974,OrlandoLiberal,5,0,0,5,0,14402,[],[]
898608295,pixie_nani,0,0,0,0,0,758,[],[]
14330379,sameoldstory,19,1,1,18,0,799,[],[]
1258378220090658816,HPT30147483,0,2,0,0,1,407,[],[]
3303153196,SilversteinUSA,7,0,2,5,0,1398,[],[]
785102612,TedGenoways,68,1,12,56,0,10649,[],[]
3232992290,kalphoto_la,0,0,0,0,0,227,[],[]
1288355688196919296,Shirley18835103,0,0,0,0,0,19,[],[]
1344090906991992834,GreatUSParty,0,0,0,0,0,14,[],[]
778701091,rechesnut,3,0,0,3,0,35,[],[]
2734574376,wendyp4545,692,95,156,536,53,21748,[],[]
921921750253883392,pbno20,1,1,0,1,0,96,[],[]
920257832,MinnesotaMaryS,63,1,14,49,2,5740,[],[]
826104850194653186,Jillibean557,21,0,7,14,0,46589,[],[]
1593621210,MusicCityBrews,1,0,0,1,0,983,[],[]
1198387561,HeartThrobHanna,3,0,0,3,0,198,[],[]
4854595394,megerschelo,0,1,0,0,0,48,[],[]
3346680233,villhelmbock,7,0,3,4,0,247,[],[]
521812772,HeidiLiFeldman,32,1,4,28,0,10214,[],[]
1124894956970135552,Jeanett32791947,0,0,0,0,0,207,[],[]
1270907633688592384,GapeState1,1,0,0,1,0,408,[],[]
805027416,inno_organ,0,0,0,0,0,645,[],[]
1001272935087210496,RealEricCSteele,1,1,0,1,0,4742,[],[]
545358389,34Carl34,0,0,0,0,0,1217,[],[]
446562927,MScottieLowery,11,1,2,9,0,484,[],[]
467047256,Chris_Roberts54,3,0,0,3,0,64,[],[]
2693513723,TheClayMorgan,2,0,1,1,0,43,[],[]
28416273,rkieru,0,1,0,0,0,60,[],[]
20025984,anewman35,0,0,0,0,0,108,[],[]
757623437938556928,evyn_14,0,0,0,0,0,30,[],[]
82245743,connect27,0,0,0,0,0,247,[],[]
1316070548938485760,Timothy29354421,0,0,0,0,1,8,[],[]
1074411241874055170,GreggASmith3,0,0,0,0,0,479,[],[]
1263128870594719745,JimBrewster18,0,0,0,0,0,19,[],[]
717844027828264961,jmbenson1491,100,7,30,70,3,60487,[],[]
1009402887947071488,aarivdaniel,0,2,0,0,0,59,[],[]
117082566,DBrodyReports,7167,308,1262,5905,181,31791,[],[]
1324259566121603072,SageSubway,0,0,0,0,0,1,[],[]
1325621919190708225,MattBartruff,0,0,0,0,0,7,[],[]
1645923469,catrawlins,0,0,0,0,0,3,[],[]
59445149,oleester,0,0,0,0,0,257,[],[]
279234400,KealaKaa,0,0,0,0,0,5916,[],[]
1465631280,willrunforwine0,0,0,0,0,0,220,[],[]
438760741,ADudones,0,2,0,0,0,1282,[],[]
159524468,DaveWallaceUS,2,0,1,1,0,3584,[],[]
365606579,ELF1955,1,0,0,1,0,10612,[],[]
1213904018021343233,realjurgmeister,36,2,6,30,0,424,[],[]
954174254,lindaperriello,1,0,0,1,0,357,[],[]
788418341593505792,labubbakeith,5,0,1,4,1,1102,[],[]
4053624917,RollClassGov,0,0,0,0,0,337,[],[]
440961086,MLP_Esq,5,0,0,5,1,746,[],[]
1335822537167659008,YourselfFk,9,1,3,6,0,4,[],[]
607739450,PurpleNinjaGrrl,0,0,0,0,0,195,[],[]
3039442514,tzed928,0,1,0,0,0,13,[],[]
15910202,RaychelTania,31,7,3,28,1,10887,[],[]
1292620070,txconservgirl,20,1,9,11,3,1576,[],[]
1177624521244893185,high_citizen,0,0,0,0,0,2892,[],[]
1330132437377179655,Francis02591382,0,0,0,0,0,21,[],[]
127395594,shermjanae,0,0,0,0,0,272,[],[]
1046559976834158592,Baklava_in_CA,20,3,4,16,3,5702,[],[]
3256713646,MattRedhawk,1,0,0,1,0,404,[],[]
900751120846512129,StateofusAll,699,51,126,573,38,12214,[],[]
3008290478,bordersroad,31,13,1,30,0,8231,[],[]
162450901,JMechanic,60,2,14,46,2,29831,[],[]
1069285146157768704,ThatRayShow,6,1,0,6,0,760,[],[]
100498805,TrudyLH20,18,1,3,15,1,9975,[],[]
16624923,Scarmouche,3,0,1,2,0,399,[],[]
1322401300663947264,Marissa_Meleske,0,0,0,0,0,266,[],[]
1234325617509720067,PlasticJesus9,0,0,0,0,0,1175,[],[]
38431309,jwatson1978,0,0,0,0,0,259,[],[]
942122522,GuitarSunCat,2,0,1,1,0,9044,[],[]
771560250,DaveVino,1,0,1,0,0,1570,[],[]
2263759626,PowerOfWords4U,0,0,0,0,0,63,[],[]
26420770,Subvet722,0,0,0,0,0,97,[],[]
21930092,doxie99,5,0,2,3,2,5128,[],[]
1020861701191806976,FarmerPill,0,0,0,0,0,1911,[],[]
596829907,mgreer423,5,3,0,5,0,3863,[],[]
1288562691603222528,elise_gallina,2,0,1,1,0,97,[],[]
116319448,JulieBorowski,293,90,31,262,10,67195,[],[]
1250599358153678848,Rafiarjumand,0,0,0,0,0,108,[],[]
717271758739533824,1Liberty3,2,0,0,2,0,587,[],[]
746196701296222208,Ankh1050,0,0,0,0,0,4958,[],[]
1418105372,KassieTroy,9,0,3,6,0,534,[],[]
2788186100,jimcosman2,4,0,1,3,0,855,[],[]
228052870,ralphdave,0,0,0,0,0,15,[],[]
1237806377852010496,epsech,0,0,0,0,0,1307,[],[]
47750502,BobbyGvegas,0,0,0,0,0,4449,[],[]
19173948,TennesseeChris,2,0,0,2,0,643,[],[]
1094027680138313728,CoolC04490919,0,0,0,0,0,3550,[],[]
1328576070841479170,lauries71790199,0,0,0,0,0,0,[],[]
543540672,Rogofagi1,0,0,0,0,0,1840,[],[]
719958849529118720,zuricoop1,2,1,0,2,0,20,[],[]
1883718734,mathewjmari,5,1,1,4,0,483,[],[]
985966871504535552,spunkiemissy,0,0,0,0,0,1162,[],[]
760869288,debbiegibbshalm,0,0,0,0,0,10805,[],[]
830972120385609729,Chopbill,0,0,0,0,0,225,[],[]
1284651818782535680,Oldwanderlust2,0,0,0,0,0,379,[],[]
24655916,rbsslc,0,0,0,0,0,54,[],[]
171514086,DougBillings,221,25,42,179,13,12255,[],[]
701164927776649216,yesitistime,0,0,0,0,0,217,[],[]
1225239610533523457,WaltN11,1,0,0,1,0,1,[],[]
4865469912,EndnLoneliness,6,0,2,4,0,611,[],[]
16590915,GrassRootsGuy,1,0,0,1,0,361,[],[]
2906607386,webinfo127,0,1,0,0,0,11,[],[]
154679442,bamf2510,1,0,0,1,0,51,[],[]
30346739,iamnotchjohnson,7,0,1,6,0,3870,[],[]
399542195,JLBabbitt1,0,0,0,0,0,1005,[],[]
2578819218,MarkHays22,5,2,0,5,0,347,[],[]
15700813,rr9108,1,1,0,1,0,1022,[],[]
45152916,books_beaches,2,0,0,2,0,1705,[],[]
917787538340831234,RobertMcGowen17,0,0,0,0,0,2829,[],[]
490639806,GoneSkiing48,2,0,0,2,0,502,[],[]
1120055133843255296,the__priince__,3,0,1,2,0,74,[],[]
2417533518,KeithKuprian,1,0,0,1,0,1652,[],[]
1031616117826105346,larry_shicks,1,0,1,0,0,36,[],[]
1290373560704221184,GregMcMullenCA,1,1,0,1,0,1412,[],[]
1069007124620066816,plaintalking1,0,0,0,0,0,21,[],[]
548820917,jackiantonovich,67,5,2,65,0,21263,[],[]
1313691754097500160,taylorgriffUSA,3,0,0,3,0,55,[],[]
1273064431929495557,MichaelTobia2,0,0,0,0,0,6,[],[]
1259899320532439052,TinaCoopworld,0,0,0,0,0,15,[],[]
903013178606587905,gflo322,0,0,0,0,0,12,[],[]
1301623379859038210,TBack40,0,0,0,0,0,451,[],[]
952192862283862016,precisionfence4,0,0,0,0,0,1,[],[]
809982722,SanMarcosGlass,1,0,0,1,0,4322,[],[]
49864302,femijr,0,1,0,0,0,580,[],[]
896012568514281477,Red_Shirt_Dude,0,0,0,0,0,10587,[],[]
175711368,trayNTP,1,0,0,1,0,1301,[],[]
1259261446925570056,EdwinDehart10,1,0,0,1,0,1,[],[]
2148215414,Patriotic_Jon,0,0,0,0,0,2067,[],[]
20435808,HomerWhite,35,7,9,26,0,22577,[],[]
752206711,mackzumized,0,0,0,0,0,14,[],[]
302416276,CBuch64,1,0,0,1,0,3430,[],[]
818649749268131840,scmatz,0,0,0,0,0,95,[],[]
18168399,llgb,1,0,0,1,1,2559,[],[]
1313269836009660423,Cricri2101,0,0,0,0,0,2923,[],[]
620278670,habana243,0,0,0,0,0,24,[],[]
1303386400780361735,danny2823416781,0,1,0,0,0,13,[],[]
882072548862590976,Melody7473,6,1,1,5,0,3942,[],[]
45489122,dotjenna,55,10,9,46,2,21062,[],[]
1345479404240175105,DonaldJTrumppa4,0,0,0,0,0,2,[],[]
2949463960,peanut61162,0,0,0,0,0,5,[],[]
1087884379337252866,Justlikemydad2,0,0,0,0,0,4,[],[]
883786357042278400,lex31555,15,3,4,11,1,7792,[],[]
1336391927474888704,JaquesAcab,0,0,0,0,0,30,[],[]
2880447465,hjelle_brian,28,0,4,24,0,38874,[],[]
1251981552180920320,seeusaredeemed4,1,0,0,1,0,2866,[],[]
1343283515731935233,jsbach_fan,0,0,0,0,0,4,[],[]
1343167040354480129,Raymond32397878,2,2,0,2,0,0,[],[]
1100780547771641856,DarleneNoNumber,13,0,2,11,0,7427,[],[]
60767749,Rocky1542,7,0,0,7,0,11486,[],[]
809775760219090945,TerryH430,5,0,1,4,0,1265,[],[]
133876131,MIRighttowork,0,0,0,0,0,1044,[],[]
20713662,kdawson13,0,0,0,0,0,39,[],[]
1328130515791204352,gregeggg,1,1,0,1,1,192,[],[]
739193071674347520,BullseyeBanjo,1,0,0,1,0,3574,[],[]
171469872,dhorne349,1,0,1,0,0,85,[],[]
4227291359,Pingjockey58,0,0,0,0,0,2985,[],[]
1011455602415960065,JEidswick,7,1,1,6,0,1563,[],[]
1161531383166263297,Paigll,34,2,9,25,3,10436,[],[]
1214758189,amandaslaw81,1,0,0,1,0,1793,[],[]
939559763238576128,CharlesDelecto,0,1,0,0,0,62,[],[]
22095911,DirtyAutomatik,0,0,0,0,0,1080,[],[]
20729667,Neoavatara,127,14,13,114,3,48433,[],[]
770345886002077700,_itsNeenerz_,1,0,0,1,0,258,[],[]
22721737,paramethius,0,0,0,0,0,147,[],[]
1522696928,derekjGZ,86,2,13,73,0,98518,[],[]
584374300,DebbieCanWeTalk,29,1,4,25,0,3892,[],[]
705550587488763906,kamsaildogs,0,1,0,0,0,175,[],[]
1247649959043829762,Framer12600576,0,2,0,0,0,0,[],[]
480876388,joy2850,0,0,0,0,0,10524,[],[]
17671778,TIFFLS,4,1,2,2,0,702,[],[]
127692041,NMWAY,0,0,0,0,0,17,[],[]
1323872489014001665,Jcorcoran4,1,0,1,0,0,54,[],[]
993960387208007680,annonei26307712,0,0,0,0,0,282,[],[]
1185343790959288320,davemountain10,2,0,0,2,0,0,[],[]
1256423456717012993,xxtiger44,0,0,0,0,0,1743,[],[]
37466818,shetheflyingrn,1,0,0,1,0,3682,[],[]
1332552587892166657,chochinator,0,0,0,0,0,64,[],[]
848946048202625026,gibjr2,0,0,0,0,0,9,[],[]
1207818937464954880,ThatPoliticalG1,5,3,0,5,0,19,[],[]
28229298,soulgalaxygirl,0,0,0,0,0,1120,[],[]
54531360,PatForestHills,0,0,0,0,0,99,[],[]
2858907321,palmerbob969,1,0,0,1,0,105,[],[]
1144466870898049024,snugglebutt187,6,1,0,6,0,263,[],[]
21821418,h65heloman,0,0,0,0,0,94,[],[]
190133470,tintbrent,0,0,0,0,0,61,[],[]
743518027250044930,leigh_league,0,0,0,0,0,1829,[],[]
832788979393060867,MRSpinkston85,41,1,1,40,1,14814,[],[]
24260950,Justgreat79,2,0,0,2,0,191,[],[]
418196712,thewizpalace,7,0,0,7,0,554,[],[]
1070253791767814144,PlayerIncognito,0,0,0,0,0,5,[],[]
1262072691089178631,OldThingsNew2,2,0,0,2,0,494,[],[]
592244584,GinGander,32,6,5,27,4,79188,[],[]
782502824,PussonaPelona,0,0,0,0,0,154,[],[]
120279314,strypdrock,1,1,0,1,0,240,[],[]
150078976,ChrisMurphyCT,14651,582,2277,12374,235,1081186,[],[]
1341454291530362901,ArtzenAlesander,2,0,1,1,0,1,[],[]
71040937,Blu3y3dBalla,2,2,0,2,0,390,[],[]
2824481755,GOP_WH_News,1,0,1,0,0,202,[],[]
2624666477,UsmcCraig,2,0,0,2,0,3498,[],[]
1159566234913869824,jonzaster,0,0,0,0,0,18,[],[]
3928769359,winterj67,0,0,0,0,0,70,[],[]
73698410,nschlinger,0,0,0,0,0,647,[],[]
1109405977,iamcoolallison,8,1,0,8,0,216,[],[]
798510085,erob1956,2,1,0,2,0,155,[],[]
238981623,joynhim2011,0,0,0,0,0,42,[],[]
1173452054481625089,MissBlueSkyLa,3,0,0,3,0,1506,[],[]
1229262746786680833,KagAshley,0,0,0,0,0,3124,[],[]
1153114176971296768,Emz_2184,0,0,0,0,0,38,[],[]
758677666710990848,ahop83,1,0,0,1,0,207,[],[]
2868241610,kenbax47,0,0,0,0,0,1607,[],[]
3267415332,ecarriz624,0,0,0,0,0,31,[],[]
18460821,littleranran,0,0,0,0,0,36,[],[]
764932986131378176,Impeach_Cheeto,9,0,1,8,0,11347,[],[]
96048286,ilovemusicks,0,0,0,0,0,216,[],[]
819627806501933056,TheOnlyKenrick,0,0,0,0,0,178,[],[]
1021404763819298816,FredR15586266,110,16,15,95,3,2386,[],[]
2449913803,MsAvaArmstrong,7956,419,1890,6066,310,144163,[],[]
17796110,SSTrihan,5,1,1,4,0,314,[],[]
1225081498988154880,barney31912373,0,1,0,0,0,29,[],[]
15504320,jcflyer,0,0,0,0,0,349,[],[]
337062648,Rightwinger65,3,0,1,2,0,1444,[],[]
27283890,whotnaught,0,0,0,0,0,2984,[],[]
735805849,DalLad18,0,0,0,0,1,64,[],[]
1096547763993669632,queermsfrizzle,26,3,1,25,0,4507,[],[]
882220685942239232,OllieJonesNBPT,0,0,0,0,0,38,[],[]
14274047,IsolaniD4,0,0,0,0,0,1964,[],[]
1207317096406884353,SarcasmSpewer,0,0,0,0,0,29,[],[]
1229869943027634176,join_2020,0,0,0,0,0,30,[],[]
174237455,scarlettrabe,55,2,9,46,2,48518,[],[]
3255952285,Ben_Jammin_John,4,0,0,4,0,99,[],[]
786214972233699328,lisawither,1,0,0,1,0,3501,[],[]
1225571389,Slnt_cartogrphr,0,0,0,0,0,842,[],[]
10792172,KnoxViews,8,1,1,7,0,4325,[],[]
1341189356111990788,predacle,0,0,0,0,0,80,[],[]
958408514807967751,NewDayForNJ,1906,79,378,1528,35,70424,[],[]
1058088577433780224,Arditi_d_Popolo,8,2,0,8,0,1288,[],[]
88054623,danielhayward,4,1,0,4,0,1903,[],[]
19300685,rgarton79,0,1,0,0,0,178,[],[]
21497609,cannon367,1,0,0,1,0,350,[],[]
40948247,bradley1a,0,0,0,0,0,436,[],[]
707976601,GarywFrancis,0,0,0,0,0,7,[],[]
1158403304294166530,pennsatucky2017,0,0,0,0,0,3278,[],[]
1339117487955251200,dustybass1954,0,0,0,0,0,23,[],[]
902502499575259136,__goldfinger,0,0,0,0,0,33,[],[]
2196907201,abhook1,0,0,0,0,0,30,[],[]
536305079,RStarovich,2,0,0,2,0,1850,[],[]
3832037113,stephanaghaagha,3,0,0,3,0,295,[],[]
185668507,marriottg,0,0,0,0,0,405,[],[]
1331023800121475073,Vicki51204807,0,0,0,0,0,0,[],[]
76999134,headhunter1993,1,0,0,1,0,1634,[],[]
46519629,andygrossberg,11,2,3,8,1,3927,[],[]
935334985430700032,QoachGarett,0,0,0,0,0,602,[],[]
4855758676,rustedspurid1,0,0,0,0,0,661,[],[]
856488270,ArthurAndrews5,0,0,0,0,0,646,[],[]
2423265314,urbeardtho,1,1,0,1,0,185,[],[]
2884591025,jdporterlive,2,0,0,2,0,267,[],[]
1007330705049780224,andres_glr,21,4,3,18,1,2026,[],[]
43185692,wpmullen,0,0,0,0,0,615,[],[]
46436628,chriscoleo,0,1,0,0,0,107,[],[]
1337919770511937538,ezed62,0,0,0,0,0,143,[],[]
1702968608,Johng249,0,1,0,0,0,2,[],[]
2232214039,gibsongirlmo,0,0,0,0,0,116,[],[]
28824264,thefakeSilong,18,0,2,16,1,2516,[],[]
1224491617765203968,CauseMofoSaidSo,0,0,0,0,0,156,[],[]
20844257,RyanWalis,2,2,1,1,1,16141,[],[]
3337560957,sicily_t,0,0,0,0,0,2383,[],[]
27319026,storygrrl,1,0,1,0,0,344,[],[]
716751830,NikiAry1,0,1,0,0,0,42,[],[]
913218492974927872,LeaveCrosscheck,23,1,8,15,0,2870,[],[]
41278789,jamespittsiv_i,3,1,0,3,0,212,[],[]
6499252,cliothemuse,1,0,0,1,0,521,[],[]
1058657537208262657,KnowsaG,0,0,0,0,0,22,[],[]
19411745,_Nicola,0,0,0,0,0,42,[],[]
292045956,bluerunner45,0,1,0,0,0,2136,[],[]
880895576111370240,PauletteParis1,30,3,6,24,0,22802,[],[]
828724403932389377,SeventhSon6,0,0,0,0,0,172,[],[]
864615099243405313,jv_kenny,0,0,0,0,0,54,[],[]
31029145,bbutt50,0,0,0,0,0,159,[],[]
15396541,evefairbanks,2,0,0,2,0,4562,[],[]
1326337106956914688,Terryst15479468,0,0,0,0,0,13,[],[]
3232154714,queenalmamarie,28,2,6,22,0,12447,[],[]
1157848416279396352,CyrusAParsa1,6120,285,1575,4545,222,56173,[],[]
3170146096,makeouthillrec,0,0,0,0,0,40,[],[]
965631209089855488,snikyl612,0,0,0,0,0,33,[],[]
387245680,brandnchasebell,0,0,0,0,0,33,[],[]
19458294,slacquin,0,0,0,0,0,106,[],[]
1207027592215384067,blitz204,2,0,0,2,0,184,[],[]
887686627,kkdgolf,0,0,0,0,0,57,[],[]
1247302624279441409,EdwardF92940541,0,0,0,0,0,207,[],[]
972352410998865920,QpDoll1,0,0,0,0,0,369,[],[]
2720204619,JakeMc945,125,4,46,79,8,19224,[],[]
282647792,davramdavram,10,0,0,10,0,13531,[],[]
18937727,tisbury,11,0,3,8,0,28,[],[]
2558256107,suealjen,0,0,0,0,0,1165,[],[]
21041997,richhazel,3,0,1,2,0,882,[],[]
43055120,BrockRides,5,1,0,5,0,2587,[],[]
237845487,GeorgeTakei,13519,673,1948,11571,153,3343207,[],[]
1344866012139638786,mor67942384,0,0,0,0,0,0,[],[]
1620880639,STSTCast,2,0,0,2,0,4061,[],[]
22075159,Jersey_Craig,33,2,4,29,0,43943,[],[]
109674525,alkorozim,0,0,0,0,0,43,[],[]
40478088,Robyn780,10,2,0,10,0,2163,[],[]
799646661844799488,JoelVirts,0,0,0,0,0,70,[],[]
25120844,cschormann,1,1,0,1,0,1431,[],[]
1271270387813429249,ReconBear66,0,0,0,0,0,12,[],[]
144718129,maryo55,1,1,0,1,0,31,[],[]
758402256,JosephGreene8,1,0,0,1,0,266,[],[]
742576167400660992,Mikehanlon10,0,0,0,0,0,58,[],[]
20692332,DrMichaelLBrown,238,126,28,210,11,44861,[],[]
1274790051310759936,WildCatDidGrowl,2,0,0,2,0,7,[],[]
1323035437233893376,memes_range,0,0,0,0,0,4,[],[]
432045484,BergPeggy,0,0,0,0,0,192,[],[]
985483598,FiddlerForest,2,1,0,2,0,1610,[],[]
513845962,StellarianNoah,0,0,0,0,0,275,[],[]
705890784319377409,Dlw20161950,2,0,1,1,0,8063,[],[]
925923095436775424,Atticus59914029,180,27,19,161,1,13299,[],[]
1100582731371573248,MaryLou86203706,0,0,0,0,0,6,[],[]
105834172,HarvF,2,0,0,2,0,4422,[],[]
961710457,aleprechaunist,0,0,0,0,0,1071,[],[]
1066129299487563776,LieLikeCheeto,0,0,0,0,0,74,[],[]
1320386266274369536,CarrasquelChico,0,1,0,0,0,31,[],[]
19921435,InFullBloomUS,1,0,0,1,0,17673,[],[]
1118527139081486336,sonofthesouth85,0,0,0,0,0,49,[],[]
1320123412166156294,LStawiery,0,1,0,0,0,68,[],[]
819184438978420736,randyc626,0,0,0,0,0,1,[],[]
328246041,juliealdermanb,11,1,0,11,0,1731,[],[]
1899058134,GrumbleKev,1,0,0,1,0,61,[],[]
1262159375109685248,FreedomLover82r,1,0,0,1,1,428,[],[]
1305621563316809728,LisaLuvsLiberty,7,2,1,6,0,2429,[],[]
191615018,jtinaglia,0,0,0,0,0,3688,[],[]
160760873,Dr_JRTate,1,0,0,1,0,475,[],[]
712389280946118656,Karencrisci1,0,0,0,0,0,3622,[],[]
867956416052637696,MMGanstine,0,0,0,0,0,16,[],[]
359442638,rudytoot1,0,0,0,0,0,1560,[],[]
35581158,nvrqt,0,0,0,0,0,662,[],[]
28803892,MazvitaJames,57,4,8,49,2,14731,[],[]
1267444833674760192,NC_Jedi,0,0,0,0,0,17,[],[]
74082296,nonsumdignus,2,1,0,2,0,4952,[],[]
1187075017843961856,sandral26370258,0,0,0,0,0,6,[],[]
419101819,namesarecliche,0,0,0,0,0,64,[],[]
797617202958626816,MaryCol69061277,7,0,2,5,1,695,[],[]
191124551,LAppiah,15,3,3,12,0,4781,[],[]
1155836192807669760,ElleDew2,0,0,0,0,0,110,[],[]
862412810,GuyChicago5151,549,96,119,430,27,11956,[],[]
1263846484845498370,kardinal_der,1,0,0,1,0,17,[],[]
21473334,kbiegel,21,2,1,20,0,15286,[],[]
1342927263076147201,Tree17Little,0,0,0,0,0,18,[],[]
253656666,Minuteman04,104,5,23,81,3,14776,[],[]
2978750830,Pray1forliberty,0,0,0,0,0,1052,[],[]
293093835,hughes_bob,0,0,0,0,0,14,[],[]
2902879735,WalsonBot,2,1,0,2,0,76,[],[]
1111314673935233024,busy_fig,0,0,0,0,0,85,[],[]
16870810,kcohio,2,0,0,2,0,3255,[],[]
109325358,ProfDNgong,0,0,0,0,0,957,[],[]
119132727,margih99,0,0,0,0,0,2442,[],[]
968373998,Lord0fThePog,1,0,0,1,0,5397,[],[]
19519368,Yoopocrates,0,0,0,0,0,137,[],[]
3074008982,HopkinsBuchanan,1,0,0,1,0,26,[],[]
1295926830,JustinDvlRey,0,0,0,0,0,196,[],[]
2533994718,Sunnydez861,0,0,0,0,0,29,[],[]
26761733,calistevenj,30,5,10,20,1,81149,[],[]
1247219098280476673,MaryAnnSeltzer4,0,0,0,0,0,0,[],[]
56691473,sportsbabe33,0,1,0,0,0,122,[],[]
825544363757465600,bluearcher1600,0,0,0,0,0,252,[],[]
45374621,jetpen,0,0,0,0,0,205,[],[]
1496642329,RxwtlossChuck,1,0,0,1,0,55,[],[]
1904304403,DianaVerrall,0,0,0,0,0,21,[],[]
32216764,cmkenlin,2,0,0,2,1,805,[],[]
54371931,KittyCat613,4,0,0,4,0,485,[],[]
1038803348483461120,BrianMa13713087,0,0,0,0,0,4,[],[]
1317157574056251392,CornpopJohnson,0,0,0,0,0,349,[],[]
788100454161014784,CurtMccutcheon,0,0,0,0,0,2208,[],[]
1076565911501398017,JohnnyHarp10,0,0,0,0,0,1,[],[]
412847710,chrismovienerd,12,1,1,11,0,15336,[],[]
1228801016684011520,Sw654,4,0,2,2,1,1150,[],[]
190215732,KCV16,0,1,0,0,0,43,[],[]
23979605,semacks,0,1,0,0,0,325,[],[]
978454670111887360,Polit_eurOpines,13,1,2,11,1,1326,[],[]
3220213625,SoMikeJust,1,1,0,1,0,41,[],[]
1272677798298165253,BarryMc19085822,1,0,0,1,0,31,[],[]
550085495,Singh13Das,0,0,0,0,0,22,[],[]
722462102,CHN_AdamWodon,10,2,0,10,0,2299,[],[]
1336901419,steveweidberg,5,1,2,3,2,3383,[],[]
23136128,peacetat,0,0,0,0,0,144,[],[]
960226339629535232,morrismd1918,10,0,4,6,1,3115,[],[]
2827804310,jrcflatheadmemo,22,2,4,18,1,1565,[],[]
248093041,prc4aam,11,1,3,8,1,10950,[],[]
150995770,LowmanX,1,0,0,1,0,340,[],[]
3888041654,Comfynumb15,0,0,0,0,0,2138,[],[]
1274527851153371140,MeidasMariaLili,0,0,0,0,0,101,[],[]
3218189220,nolahaynes_,2,2,0,2,0,3944,[],[]
3905905514,BLUIZK81,3,0,1,2,0,1994,[],[]
30136389,EqualUnderLaw12,2,0,0,2,0,496,[],[]
129971447,piolilly,1,0,0,1,0,81,[],[]
1896473412,ATomalty,84,0,11,73,4,4306,[],[]
846385824002293760,pegiiione,0,0,0,0,0,4107,[],[]
168626494,Youthguy07,57,7,8,49,1,7178,[],[]
1260752773093691392,HulkThePatriot,1,0,1,0,0,3414,[],[]
536897047,FakaktaSouth,69,6,6,63,1,5304,[],[]
2559819783,bh17312003,0,0,0,0,0,17,[],[]
20897273,PAMsLOvE,41,3,8,33,0,588963,[],[]
1198079992472539136,Steven43970846,0,0,0,0,0,1425,[],[]
16073459,benm328,1,0,0,1,0,227,[],[]
892036631766720512,CharlesRobinLee,0,0,0,0,0,2720,[],[]
710908350398111745,eagleonetowanta,74,3,19,55,8,6032,[],[]
161915872,ToR_BaYeR,3,0,1,2,1,2534,[],[]
1332515901728464896,kk202059030717,0,0,0,0,0,2,[],[]
529040648,Voghs456,2,0,0,2,0,133,[],[]
59209966,tom_modern,0,1,0,0,0,624,[],[]
1230392871955652609,Southpaw_Real,0,0,0,0,0,21,[],[]
217820377,ginamilana01,2,2,0,2,0,396,[],[]
1333825461990854657,OfeldtRyan,0,0,0,0,0,24,[],[]
2418613734,TomRGregg,1,0,0,1,0,268,[],[]
1345024782560096256,Clif39897988,0,0,0,0,0,0,[],[]
1260922124,andrewwhomst,0,0,0,0,0,222,[],[]
1225553849311645696,John_G_Watson,0,0,0,0,0,1216,[],[]
61905775,FrankandFroogle,0,0,0,0,0,4803,[],[]
329975929,scripter_2011,0,0,0,0,0,20,[],[]
80721062,ThatMOVDude,0,0,0,0,0,504,[],[]
19020455,kcwilson781,0,1,0,0,0,47,[],[]
1202691154262839304,HeinzMa63322805,0,0,0,0,0,60,[],[]
1297083061,JaeaGeep,0,0,0,0,0,605,[],[]
758110538,UnRepConsrvtive,1,0,0,1,0,2170,[],[]
226997507,SunilKumarAus,50,10,21,29,2,3443,[],[]
802137370598457344,SamPlayItAgain1,1,0,0,1,0,837,[],[]
35375399,dtlewis6,0,0,0,0,0,986,[],[]
25004714,ironburton,1,0,0,1,0,429,[],[]
606799273,BKilhams,0,0,0,0,0,75,[],[]
526771261,Josh_H13,0,1,0,0,0,164,[],[]
1112724144427139072,JamesBradleyCA,407,11,46,361,3,41049,[],[]
945795466746384385,AngelTedrow,0,0,0,0,0,3,[],[]
1269102812782346240,AyeAyeSir4,0,0,0,0,0,544,[],[]
193310908,paul4laffs,0,0,0,0,0,791,[],[]
75137937,VeganAri,96,2,7,89,0,21044,[],[]
1091904062554075136,BillK88583375,1,0,0,1,0,2970,[],[]
15059114,charasan,0,0,0,0,0,312,[],[]
1209012233327403009,CosminVisan3,1,0,0,1,0,276,[],[]
763008115860131842,Susanodo1974,0,0,0,0,0,2,[],[]
1852777106,jasongoldberg7,0,0,0,0,0,39,[],[]
992090639813627904,DarinTurner8,0,0,0,0,0,387,[],[]
1116005133899272192,RatioHallFame,1,0,0,1,0,538,[],[]
64537827,brandibuzzard,62,4,0,62,0,5348,[],[]
1309594491645431808,BrianFalslev,1,1,0,1,0,1,[],[]
716374235602665472,caitlinmcqulity,7,1,0,7,0,875,[],[]
41749124,AssassinGrl,2,1,0,2,0,3761,[],[]
974997176077225984,RealFrankFloyd,0,0,0,0,0,1991,[],[]
823363168676278272,TheJuliaEzell,0,0,0,0,0,61,[],[]
1939490418,RolandWall,0,0,0,0,0,2941,[],[]
49511290,Pepesplants,5,0,2,3,0,10911,[],[]
77254498,deepgreendesign,6,1,1,5,0,9295,[],[]
1321832694385385472,ShannondoahE,0,1,0,0,0,595,[],[]
869032177,MomAnonMi,0,0,0,0,0,2349,[],[]
1221295109146214400,Revolut08335670,38,9,13,25,2,2664,[],[]
89601054,drb2567,0,0,0,0,0,193,[],[]
1328726355362529281,MohitKopinion,0,1,0,0,0,277,[],[]
1257341876602114062,curt_north,1,1,0,1,0,290,[],[]
1343545737787961346,Paulthepatriot2,0,0,0,0,0,2,[],[]
783494577869041664,Yvonnem01753850,0,0,0,0,0,398,[],[]
845426144916766720,MeerkatsRMammal,8,0,0,8,0,1502,[],[]
3020395131,PDykie,6,2,4,2,1,1590,[],[]
705668492,sabergermd,6,1,2,4,0,4312,[],[]
1341075013735202822,JLowery76170106,0,0,0,0,0,110,[],[]
180834935,leonardocarella,9,0,0,9,0,20966,[],[]
151000824,marie_donigan,1,2,0,1,0,625,[],[]
1231687444241711105,antisocialiteg1,0,0,0,0,0,1236,[],[]
627600160,pritchetttm,1,1,0,1,0,1334,[],[]
493526610,MarkJacob16,1284,44,371,913,40,41513,[],[]
629605316,realhuntdog23,5,2,0,5,0,424,[],[]
35051846,MichaelHuff01,0,1,0,0,0,39,[],[]
1178136336827445248,DunreyAhaha,0,0,0,0,0,61,[],[]
165900797,n5p6hd2kwie,0,1,0,0,0,20,[],[]
1319346864370544640,tokertimlives,1,0,0,1,1,58,[],[]
2480955596,Sukietweet,0,0,0,0,0,120,[],[]
23204187,amack2,9,0,3,6,0,697,[],[]
2745348565,ALilac6,0,0,0,0,0,1360,[],[]
17630666,geoff_ras,0,0,0,0,0,56,[],[]
892361417369714688,SW13687,0,0,0,0,0,40,[],[]
24449020,grandstick,1,0,0,1,0,81,[],[]
256622288,MikeyJ555,0,0,0,0,0,106,[],[]
1858882886,JMichaelWaller,178,21,41,137,4,35534,[],[]
374296790,Dr_Zil_White,0,0,0,0,0,1155,[],[]
66272712,Lana40,11,1,4,7,0,1926,[],[]
1091216816,thetoyman1,524,39,160,364,17,65563,[],[]
1958032140,RealJanesville,0,0,0,0,0,189,[],[]
1040355662608388096,Jeff16253820,0,0,0,0,0,238,[],[]
1327089807797989376,DuzanAngela,0,0,0,0,0,269,[],[]
296798368,mapgirl18,19,1,0,19,0,1833,[],[]
757717165,mrsmilky,4,0,0,4,0,240,[],[]
789203683858714624,idont_wantto,2,0,1,1,0,182,[],[]
