User ID,User Name,Node_weight,Reply Count,Retweet count,Like Count,Quote Count,Followers Count,FOllowerID,Follower name
22054767,Mavadar,2,0,0,2,1,390,[],[]
2579495672,kimmmyparsons,1,1,0,1,0,1165,[],[]
1052041932220719104,glamoureptile,78,6,8,70,0,14121,[],[]
1251920652199739400,xrpDon2,2,1,1,1,1,42,[],[]
1026611976909271041,Archie2D,2,0,1,1,0,15,[],[]
979053160785301505,LitterickB,0,0,0,0,0,278,[],[]
1203613905882365952,SChiringuitos,8,1,1,7,0,3961,[],[]
973337647212040192,mestroubles,0,0,0,0,0,99,[],[]
25282419,WStuartross,7,0,0,7,0,1805,[],[]
18855288,JoshuaMac22,3,3,0,3,0,640,[],[]
409604221,SamLades,0,1,0,0,0,128,[],[]
981184371544809472,mcmaster_robin,0,1,0,0,0,65,[],[]
723460223789359104,benzadeos,0,0,0,0,0,239,[],[]
2315698776,mchooyah,2451,366,113,2338,59,487502,[],[]
386764875,daltonator,24,4,1,23,0,1672,[],[]
424273037,MattSkrajner,4,2,0,4,2,1642,[],[]
49444685,RStormC,0,0,0,0,0,22,[],[]
3022961,ChickenscratchJ,2,0,0,2,0,75,[],[]
16446919,celebratewewill,0,0,0,0,0,194,[],[]
562227689,DonnaKaySpeaks,2,1,0,2,0,175,[],[]
263487754,WilliamDWheeler,65,9,3,62,1,5035,[],[]
148016274,tomiwalamies,9,0,0,9,0,4147,[],[]
371562139,Davis_404,0,0,0,0,0,531,[],[]
2406453398,mylaminoki,1,0,0,1,0,106,[],[]
2381551327,ChrisEstrada85,132,2,3,129,1,4266,[],[]
25843801,lau56,18,3,2,16,1,23552,[],[]
1376566435,DukeKalita,1,0,0,1,0,1020,[],[]
29525237,AlTheKiller,0,0,0,0,0,451,[],[]
1167610747838316544,lovehousewives2,17,0,1,16,0,234,[],[]
370762184,Bibliophile615,1,0,0,1,0,588,[],[]
1936672327,CogitoErgoWtf,23,2,3,20,0,7544,[],[]
874366168080896000,aggeir,2,0,1,1,0,26,[],[]
42572551,calliopes_muse,6,3,0,6,0,532,[],[]
392405067,frasersimons,7,0,0,7,0,2489,[],[]
33913156,notcapnamerica,87,10,10,77,1,72314,[],[]
2273295228,TimSoefje,0,0,0,0,0,6300,[],[]
236962501,AndrewSleighter,1,0,0,1,0,2011,[],[]
501354527,CurtinLovesYou,0,0,0,0,0,611,[],[]
54510542,WhoIsYoda,2,1,0,2,0,1006,[],[]
153283741,Tommer82,1,2,0,1,0,14969,[],[]
1220650550,hecivan70,3,4,0,3,0,1586,[],[]
154733396,spar1091,2,0,0,2,0,864,[],[]
2189257184,Virgini98900230,0,2,0,0,0,1982,[],[]
830561635492315136,_coconono_,5,1,0,5,0,2853,[],[]
159021888,adamajacoby,690,29,146,544,24,13366,[],[]
958492260940820480,realskybro2465,0,0,0,0,0,191,[],[]
239005322,CalebJHull,721,56,64,657,14,161311,[],[]
4831450822,abv8t7,0,1,0,0,0,13,[],[]
12368942,tonydunn,0,1,0,0,0,83,[],[]
889909938,hbokujokiriya,88,8,1,87,4,916,[],[]
937881313822076928,seaJLgull,7,0,2,5,0,1809,[],[]
18597090,fabricamargo,0,0,0,0,0,322,[],[]
1130155790118076418,Cincyschnecken,1,0,0,1,0,194,[],[]
1005111233383579655,Schtaunkhauser,13,0,4,9,0,1356,[],[]
1329441221295665156,saccovanzetti6,0,0,0,0,0,21,[],[]
935519766,IWillYeetYou,3,1,0,3,0,775,[],[]
14935218,daezer,0,0,0,0,0,81,[],[]
19329149,JD_Oliva,18,2,1,17,0,2209,[],[]
827532801037705216,thatangrymick,1,1,0,1,0,226,[],[]
216478691,HulloLarisa,4,0,0,4,0,538,[],[]
342170721,ingdamnit,6,0,2,4,0,1153,[],[]
1036692865726988288,jbtruth1,0,0,0,0,0,123,[],[]
1336421896787800064,MaestroUnity,0,1,0,0,0,274,[],[]
15476712,JCrongeyer,942,71,130,812,12,52162,[],[]
4327127414,santiagomayer_,4479,567,576,3903,117,143999,[],[]
10930732,birdrainbows,0,0,0,0,0,54,[],[]
1189929689441280003,iamtranslol,1,0,0,1,0,73,[],[]
22863005,McCully,1,0,0,1,0,1583,[],[]
1236454524065320960,Nicolasa_UK,3,2,0,3,0,1956,[],[]
1131999313805107205,justdrew404,1,0,0,1,0,403,[],[]
2955356551,yankeekathall,4,0,2,2,0,12176,[],[]
797695564666257408,coolguyrespect,0,0,0,0,0,86,[],[]
269887907,nickbackovic,21,2,0,21,1,3884,[],[]
1340421183238328320,igaveherabev,0,0,0,0,0,1,[],[]
146151930,themaholupper,0,0,0,0,0,3062,[],[]
1262335255,IrvinWithAnEye,0,0,0,0,0,93,[],[]
3853589176,Daniel2Wolves,5,0,1,4,1,471,[],[]
191235341,brod0815,1,0,0,1,0,248,[],[]
150081284,BrothaDom,0,0,0,0,0,1028,[],[]
83924623,mbgm__,3,0,0,3,0,405,[],[]
880859696428535808,TheRealRobato11,2,1,0,2,0,1372,[],[]
100363558,PrimiSecundi,6,1,0,6,1,501,[],[]
1134982831363436545,mouvement33,79,1,23,56,1,18815,[],[]
1292646631586881536,ImKarenDammit,0,0,0,0,0,60,[],[]
73276861,PEARLfectChassi,3,0,1,2,0,2411,[],[]
1337220808599597056,Raye4M,0,0,0,0,0,221,[],[]
21997477,Cigaran,0,0,0,0,0,87,[],[]
942584660944592896,baybridges3,0,0,0,0,0,133,[],[]
25398204,MURTWITNESSONE,9,2,1,8,0,3545,[],[]
1322764694839562241,JustTyler98,4,1,0,4,0,246,[],[]
24820720,PotatoesOGrady,8,0,1,7,0,1726,[],[]
304098617,SamtanicPanic,0,1,0,0,0,290,[],[]
103248912,kazua_,1,1,0,1,0,736,[],[]
2764631099,Stello_Official,3,0,0,3,0,12037,[],[]
117342531,seaisforcarlo,1,0,0,1,0,23,[],[]
2701633938,tamgar617,3,0,0,3,0,1852,[],[]
227917633,conversewearing,1,0,0,1,0,3303,[],[]
3988277594,slayyyters,1,0,0,1,0,5265,[],[]
22526677,erikbransteen,4,0,0,4,0,32119,[],[]
1125683750917087232,TiptonDems,1,0,0,1,0,487,[],[]
10202402,sylamore1,34,7,1,33,0,7145,[],[]
325016010,MaxAMaxim,17,0,4,13,0,10177,[],[]
708982061,Blogsbloke,1,0,1,0,0,555,[],[]
1074128326770483205,QLargo1,4,6,0,4,1,234,[],[]
114058726,KillGoldfish,7,1,0,7,0,1067,[],[]
1302743441772740609,JaydenAndressen,2,0,0,2,0,35,[],[]
623320031,strangeperse,16,0,1,15,0,447,[],[]
631471058,IzzyKamikaze,203,5,22,181,1,16336,[],[]
816661099953192961,eutychusok,0,0,0,0,0,84,[],[]
986533467109310464,goldenage963,1,0,0,1,0,536,[],[]
457350347,SamP1977,0,0,0,0,0,155,[],[]
1275556749555240960,gnarlyhaze420,5,0,2,3,1,100,[],[]
812011013851623425,Michael87494463,0,0,0,0,0,233,[],[]
785913282691371008,Sir_Mrgl_Grgl,0,0,0,0,0,89,[],[]
2569154647,orange_grimace,5,1,0,5,0,327,[],[]
2141011,tomhardly,0,0,0,0,0,648,[],[]
4191161,geedeck,0,0,0,0,0,625,[],[]
1307572646620442624,2Hubris,0,0,0,0,0,112,[],[]
141233407,joesabin,0,0,0,0,0,1508,[],[]
604332148,michael29187044,2,1,0,2,0,328,[],[]
16435523,schezar,17,0,6,11,0,1472,[],[]
18638009,FlynnRoad,0,0,0,0,0,247,[],[]
23782347,johnpaulkeith,770,8,161,609,14,4336,[],[]
1297182042338267137,tanstaafl6823,2,0,0,2,0,752,[],[]
349043533,simone_dela,2,0,0,2,0,1231,[],[]
780139060199362560,NashvilleResist,48,2,1,47,0,14162,[],[]
1261714013240668160,TheEpicDept,1047,13,41,1006,2,36103,[],[]
143526150,Z3itG3ist,0,1,0,0,1,837,[],[]
1159088711826649089,CrackOpsPod,1,0,0,1,0,245,[],[]
31508195,JessicaDwyer,3,1,0,3,0,1255,[],[]
1020853149492539393,TOCB10,3,1,0,3,0,1906,[],[]
1267668784472449025,hoopaloupe,1,0,0,1,0,113,[],[]
17586693,taitaisanchez,2,0,0,2,0,394,[],[]
3048900145,GameDadJP,200,17,24,176,2,13300,[],[]
63203776,tglazi,1,0,0,1,0,302,[],[]
1331806702040199169,The1776Patri0t,41,1,4,37,0,3969,[],[]
919452019907108864,ChristoSBall,5,2,2,3,1,11055,[],[]
1150463330773020672,paranoidlikes,5,0,0,5,0,7336,[],[]
270583180,Iovelandfrog,4,2,0,4,0,780,[],[]
2571495019,irish_goodbi,4,0,1,3,0,247,[],[]
14872806,silverwuffamute,18,6,1,17,0,4205,[],[]
1447209482,mjmcgheeauthor,0,0,0,0,0,628,[],[]
1330978658631217157,BuckFiden3,0,0,0,0,0,14,[],[]
1155228782392823808,PdxBipoc,3,1,1,2,0,96,[],[]
897088756171329536,PiattPatti,57,5,6,51,0,10901,[],[]
837803294625947649,TheRealTeddyBee,9,0,1,8,1,10324,[],[]
456961408,DeepBreathPeace,2,2,0,2,0,4150,[],[]
107190358,VincentTaylor37,0,0,0,0,0,208,[],[]
282680439,stuartdburns,0,0,0,0,0,151,[],[]
299376885,norlo_pdx,0,0,0,0,0,794,[],[]
1581287318,ratgirlio,6,1,0,6,0,283,[],[]
1234171820263165952,Robert33829889,5,0,0,5,0,9902,[],[]
71064697,PickleWheels,3,0,0,3,0,9,[],[]
932687804290572288,vvovnn999,0,0,0,0,0,21,[],[]
1547072761,hamil_san,3,0,0,3,0,113,[],[]
232647724,arleighhartkopf,1,0,0,1,0,83,[],[]
47180072,bmaciavelli,0,0,0,0,0,216,[],[]
1237484377040236544,sleepyfrog2,1,0,0,1,0,591,[],[]
1320582798281822208,not_alf,1,0,0,1,0,80,[],[]
129024290,anarchic_teapot,0,0,0,0,0,1992,[],[]
1125886544785444864,animris,0,1,0,0,0,20,[],[]
1030924989686398976,LeanDatham,0,0,0,0,0,6,[],[]
1099729747519700993,Stahp4RedLights,0,0,0,0,0,243,[],[]
1544257464,Kunfiadu,1,0,0,1,0,541,[],[]
18273573,hey__bonita,2,1,0,2,0,32,[],[]
1333774146807980033,AlisonBoxxer,7,0,1,6,0,5901,[],[]
716277987428044801,Saorsa1776,23,5,3,20,0,7549,[],[]
139915217,dhines1968,0,0,0,0,0,12,[],[]
819521343179882497,jessirvbbit,0,0,0,0,0,399,[],[]
110514178,BeachyPiers,19,3,1,18,0,3593,[],[]
452263436,Quimby_Jones,1,1,0,1,0,612,[],[]
19080151,TimInHonolulu,1959,59,434,1525,38,66282,[],[]
16477920,davidsancar,0,0,0,0,0,6797,[],[]
795029810036805632,JeMor00,0,0,0,0,0,319,[],[]
604788766,Chezer59,7,3,1,6,0,257,[],[]
419490554,BtotheDK,3,1,1,2,0,178,[],[]
1293596809063993352,PaiPLe9483,10,4,3,7,1,3330,[],[]
1338646404345057280,VareWilliam,0,0,0,0,0,80,[],[]
1313548522944368641,RoyJones8595120,0,0,0,0,0,6,[],[]
1121095297407516683,Darold191,0,0,0,0,0,402,[],[]
255760320,madpolecat,0,0,0,0,0,46,[],[]
3252148241,realMaxCastle,5,1,0,5,0,2328,[],[]
465005141,WSteveChandler,15,1,3,12,0,7627,[],[]
56514531,walshjp,1,0,0,1,0,278,[],[]
877942977804500992,thecoleslaws,7,2,0,7,1,9481,[],[]
48390398,ykafi,3,1,0,3,0,289,[],[]
2451899220,ExternalHomage,0,0,0,0,0,122,[],[]
281177410,GiovaSchiano,0,0,0,0,0,827,[],[]
3380644453,LolaGayleC,9,1,1,8,0,1157,[],[]
17162143,pinkdogwood770,2,0,1,1,0,1334,[],[]
195409987,POOetryman,1,1,1,0,0,2611,[],[]
331756025,GetOffMySand,0,1,0,0,0,1510,[],[]
34982750,TEAMTomeo,0,0,0,0,0,69,[],[]
137132283,makingmuffinss,0,1,0,0,0,380,[],[]
806185369943146496,CBLK08,0,0,0,0,0,239,[],[]
2254659753,gregorykingjr,0,0,0,0,0,1348,[],[]
109409145,largejack1000,0,0,0,0,0,2387,[],[]
19058868,badtux99,4,0,0,4,0,700,[],[]
1246434382618886146,ferhypfx,1,0,0,1,0,1104,[],[]
476455404,Captainyabs,0,0,0,0,0,229,[],[]
984647401691545600,whbsd_jr,0,0,0,0,0,54,[],[]
132482991,Barcode_Nation,3,0,1,2,0,14326,[],[]
1327503162140463104,Abrelosojos999,0,0,0,0,0,137,[],[]
16252674,John_Rawlings,0,0,0,0,0,1513,[],[]
241196216,ramijames,0,1,0,0,0,5643,[],[]
3412177692,razzcass1113,1,0,0,1,0,104,[],[]
405609553,stickhurler11,0,0,0,0,0,20,[],[]
1542376674,PPantsdown,154,7,15,139,2,20960,[],[]
381452460,accessjames,17,0,2,15,0,9707,[],[]
1308653041961373696,wasbippin,1,7,0,1,0,31,[],[]
937059116,ToddKolod,8,9,3,5,1,21058,[],[]
259152526,ChipBecket,2,0,0,2,0,1192,[],[]
2395258519,WuTangCannabis,4,0,0,4,0,3625,[],[]
1096602802120478723,NickTagliaferro,24,3,0,24,1,4236,[],[]
64507491,miketheitguy,3,0,0,3,0,1807,[],[]
375685351,GlassSpiider,4,1,0,4,0,420,[],[]
1301696889297928192,QOrigins,401,25,41,360,14,29272,[],[]
1481399342,daehruoyserehw,0,1,0,0,0,873,[],[]
2960690075,tazzthetazz,2,3,0,2,0,55,[],[]
1260793174689058817,samchildsDJ,1,0,0,1,0,880,[],[]
62189012,stevenj13,2,1,0,2,0,874,[],[]
972601156244393984,GaelicDream30,0,0,0,0,0,135,[],[]
55051402,Xyless,3,1,0,3,0,841,[],[]
2521772215,LeahsLounge,148,13,34,114,2,44020,[],[]
24625290,elimaru,3,0,0,3,0,144,[],[]
798022657526464512,Joe_Calexit,8,0,1,7,0,6246,[],[]
141037610,rbnstyle,73,8,3,70,0,5221,[],[]
759215157025308674,reallivedadbod,0,1,0,0,0,124,[],[]
195068602,DarrenHankins,0,0,0,0,0,44,[],[]
1315557460904603648,AlcoholicANON17,0,0,0,0,0,193,[],[]
1342918368245002240,TheShatManRises,3,0,0,3,0,333,[],[]
796061769135509504,BarrieNortonJr,0,0,0,0,0,461,[],[]
289865805,jasonselvig,3884,93,279,3605,21,50147,[],[]
27394995,sandbothe,4,0,0,4,0,282,[],[]
40146181,iboudreau,39,1,4,35,0,9910,[],[]
1111011135346507776,Leos_Universe,0,0,0,0,0,91,[],[]
2332688850,swirlzhaddy,0,1,0,0,0,35,[],[]
195835849,miahohno,0,0,0,0,0,42,[],[]
29877749,_Dharmabum_,8,0,0,8,0,1950,[],[]
19847485,gwarburton,0,0,0,0,0,1012,[],[]
1054261148537839616,SPlatizky,1,0,0,1,0,214,[],[]
3862095082,aJSDecepida,8,0,2,6,1,9282,[],[]
2787112209,djsuperonline,0,0,0,0,0,1217,[],[]
21544754,SaintSiren,0,0,0,0,0,78,[],[]
3319930181,Mac629528,0,0,0,0,0,167,[],[]
822870313,Megohelie1,0,1,0,0,0,283,[],[]
19186513,NickDobbins,4,0,0,4,0,161,[],[]
310872365,WorldOfMarkyD,46,6,4,42,2,3862,[],[]
1113043712,DownToFifer,0,0,0,0,0,1317,[],[]
19993088,jackidenise,1,0,0,1,0,66,[],[]
300519663,angel_ponders,6,1,0,6,0,2053,[],[]
780557492673662977,RuffleJax,137,4,11,126,2,2295,[],[]
214570826,M0BBER,1,0,0,1,0,271,[],[]
427719626,condiricenbeans,15,2,1,14,0,794,[],[]
45706688,admiral_annebar,19,1,0,19,0,686,[],[]
1301269243858690051,BlakeUptin,0,0,0,0,0,6,[],[]
1539855638,AGDVentures,0,0,0,0,0,13,[],[]
30343452,aPoliteAdult,0,1,0,0,0,72,[],[]
631826912,Mohoroski6,3,1,0,3,0,360,[],[]
37037314,Mim5453,19,0,0,19,0,2194,[],[]
3078469213,Locadoes,2,2,0,2,0,252,[],[]
14532780,bellatrixr,1,0,0,1,0,527,[],[]
4239649641,lancegregmason,9,2,1,8,0,3972,[],[]
31977140,FossilLocator,39,13,0,39,0,9494,[],[]
2500567945,hannahcglaser,1,1,0,1,0,368,[],[]
1342999471827935233,BlewRv,8,1,2,6,0,4,[],[]
967879572338462720,ActMeasuresDoc,487,51,110,377,27,35401,[],[]
1470888368,elcorncapitan,35,7,1,34,1,1171,[],[]
19980950,jzembik,2,0,0,2,0,3455,[],[]
47612658,deejayqf,1,0,0,1,0,967,[],[]
1342921609976426497,ABRELOS72668415,0,0,0,0,0,49,[],[]
1509974826,LFOdS82,1,0,0,1,0,268,[],[]
28377973,RobMyers1968,15,1,1,14,0,8639,[],[]
26624654,betsytrue,1,1,0,1,0,647,[],[]
1214489977762959362,MicheleScheffl1,12,0,3,9,1,1903,[],[]
17542558,LetsGoMAGA,1,2,0,1,0,348,[],[]
1236656342674407427,LadyJayPersists,289,36,14,275,0,41875,[],[]
39988740,edgewalker81,1,0,0,1,0,1175,[],[]
845843629692370944,VincibleSugar,0,2,0,0,0,61,[],[]
830771361891106816,OummotvUsa,0,1,0,0,0,543,[],[]
888955875095793664,TrainSloth,0,0,0,0,0,232,[],[]
14333918,AnitaBlanchard,9,4,1,8,0,1816,[],[]
1046107208105127936,TrueNorth_Free,0,0,0,0,0,41,[],[]
1191902777120825344,FrankGhoti,0,1,0,0,0,486,[],[]
258301954,vestitamale,0,1,0,0,0,221,[],[]
1042552535809241089,blurrycryptid,5,3,0,5,0,516,[],[]
1166343658599149571,IJReilly4,16,3,4,12,0,21223,[],[]
4789548912,UberSoldat1025,1,0,0,1,1,685,[],[]
3259871323,SpookyDeadman,2,0,0,2,0,37,[],[]
737666778092965888,guv_big,0,1,0,0,0,76,[],[]
73171915,LTTD,2,0,0,2,0,427,[],[]
1040706494923255808,ChicoSinPortico,4,0,0,4,0,1411,[],[]
2355611766,IDJoe4Congress,61,15,2,59,0,7562,[],[]
1028260403367817216,memebot9000,0,0,0,0,0,228,[],[]
28652382,RyanHarvey_,1,1,0,1,0,280,[],[]
38351876,WRPitt,26,4,4,22,1,2701,[],[]
263247105,Bensvoice,2,1,0,2,0,1347,[],[]
889291121146421250,sowegaCat,374,39,57,317,7,45717,[],[]
28855016,TinaMaeRichards,0,0,0,0,0,1153,[],[]
969240916191055875,KevinSecular2,5,0,0,5,0,6264,[],[]
17302596,CoffeeBeBestest,2,1,0,2,0,1463,[],[]
170644984,nakahara999,12,1,2,10,1,2068,[],[]
41622143,jsphflrs,1,0,0,1,0,881,[],[]
58806083,nickchef88,6,1,0,6,0,1653,[],[]
3309654696,SFL4Hillary,2,0,1,1,0,14606,[],[]
1274223574832668678,king_of_provo,2,0,1,1,0,35,[],[]
109092941,ipsiphi,0,0,0,0,0,167,[],[]
2617838864,Sasssyspanky,6,0,0,6,0,176,[],[]
87262073,MarcellusESQ,18,2,2,16,0,2660,[],[]
18688891,nopking,1,0,0,1,0,368,[],[]
238814461,chrischardy,5,0,0,5,0,550,[],[]
274135701,magneticksara,1,1,0,1,0,1098,[],[]
45076309,editt86,0,0,0,0,0,2750,[],[]
1103163066420682752,pnwarchitect,1,0,0,1,0,156,[],[]
476212156,UnclesPeaking,0,0,0,0,0,27,[],[]
3316270072,adamAuntieEm,0,0,0,0,0,223,[],[]
157074683,GenXPod,6,2,1,5,0,445,[],[]
329059137,heydonworks,27,3,2,25,0,16812,[],[]
3197484054,Daughter75,0,0,0,0,0,156,[],[]
1342867926861414403,PodSeeking,0,0,0,0,0,315,[],[]
3361640020,EmperorOTN1,0,1,0,0,0,384,[],[]
575905035,mrslasmith,2,0,0,2,0,1012,[],[]
2417209184,RockOla69,11,3,1,10,0,3117,[],[]
16231586,greenighs,1,0,0,1,0,265,[],[]
131415712,Qobrien,2,0,0,2,0,206,[],[]
31246998,chicosay10,0,0,0,0,0,380,[],[]
106961533,happymegwv,2,0,0,2,0,166,[],[]
1220109626282315778,ftbl_txmmy,1,0,0,1,0,1059,[],[]
72072454,jaronmyers,25,3,0,25,0,12017,[],[]
17027632,sandibachom,4046,133,695,3351,53,161192,[],[]
366010551,TylerJPetty,1,0,0,1,0,579,[],[]
473365037,RealAlexEwing,1,0,0,1,0,34,[],[]
77897045,lossrockhart,2,0,1,1,0,2234,[],[]
22558648,Brian_Aves,1,0,0,1,0,184,[],[]
22071069,carreramae,10,1,4,6,0,2510,[],[]
1073028938140712960,ChrisP11488,11,0,2,9,1,125,[],[]
274772424,annbauerwriter,73,6,9,64,2,33546,[],[]
1232379387103907840,Billy_ThatsIt,0,0,0,0,0,100,[],[]
1247217446441955328,LyShaman,0,0,0,0,0,16,[],[]
547776393,RenatoMaiaron,0,1,0,0,0,932,[],[]
922663407567998977,CentristMadness,22,3,0,22,0,2710,[],[]
1102345169372893184,HalforNY__,20,1,1,19,0,18332,[],[]
569401675,Procto_Log,108,15,1,107,0,7850,[],[]
855730566485901312,VikingsCymru,2,0,0,2,0,271,[],[]
1320524030164676608,Nesiemom61,0,0,0,0,0,396,[],[]
28524148,whoisben,0,0,0,0,0,81,[],[]
24449694,TheDalyPlanet,0,0,0,0,0,10777,[],[]
394260665,TweetingYarnie,49,6,8,41,0,16078,[],[]
1111297669664694272,cows4schiff,3,0,1,2,0,2720,[],[]
790229198203916291,BasketHerder,19,0,4,15,0,2661,[],[]
1042673966,PragmaticEbooks,0,0,0,0,0,1447,[],[]
814155727342211072,moonstoneowl,7,0,1,6,0,11214,[],[]
15522566,60th_Street,11,2,0,11,0,2638,[],[]
1145879930779160576,Robertsixto2,30,2,5,25,0,14413,[],[]
415132785,PizzaBoyDave,2,0,0,2,0,466,[],[]
62631545,animetvgirl,1,0,0,1,0,36,[],[]
1260027136850575363,PosVibes4Future,12,0,0,12,0,101,[],[]
1285735274799128576,Jademariev1,0,0,0,0,0,4,[],[]
2431443373,Christo80162678,0,0,0,0,0,37,[],[]
285418083,henzbo,1,0,0,1,0,778,[],[]
135257089,richardlevangie,0,0,0,0,0,2461,[],[]
1320932959,WilliamAHirsch,7,0,1,6,0,1402,[],[]
1657752720,dharmascholar,13,0,0,13,0,6093,[],[]
2229509656,_Drummershy_,58,5,4,54,1,2375,[],[]
141305078,artbykeroscene,2,0,0,2,0,997,[],[]
189335576,jgordonshare,1,0,1,0,0,433,[],[]
1352587764,gonzohostility,37,4,6,31,0,2085,[],[]
830436086,polyphonicism,0,1,0,0,0,641,[],[]
1297492929150431232,PucksM,4,0,0,4,0,223,[],[]
995671645896560640,patmat44120,2,1,0,2,0,229,[],[]
2799902812,RevRLHale,1,0,0,1,0,650,[],[]
20676302,AntiProfessor,1,1,0,1,0,2001,[],[]
1270395255586607104,StockThotz,0,0,0,0,0,157,[],[]
64999172,Redstar309Z,0,1,0,0,0,390,[],[]
1100586838337630208,noobseriously,0,0,0,0,0,179,[],[]
593769519,ksnt63,55,10,1,54,2,12267,[],[]
2545411203,HanybalHanybal,206,1,2,204,0,27284,[],[]
14066393,tehabe,2,0,0,2,0,800,[],[]
797063244963844096,FredARossi1,0,0,0,0,0,7,[],[]
34354747,badwebsites,14,2,1,13,0,28872,[],[]
807432082318303233,BigSconesJones,0,0,0,0,0,63,[],[]
506493589,DebunkMoutarde,5,0,0,5,1,2299,[],[]
746584574038257664,SamiSyrjamaki,13,1,1,12,0,2290,[],[]
2660896448,aye_yugen,0,0,0,0,0,81,[],[]
3095449603,hide_and_see9,0,0,0,0,0,314,[],[]
15863265,alibreland,17,2,0,17,0,10582,[],[]
3101990474,hidIive,0,2,0,0,0,334,[],[]
1023539623,PatrickHilsman,14,0,4,10,2,4192,[],[]
3366106331,PoliticalJoel,3,1,0,3,0,94,[],[]
21133670,cfilios,0,0,0,0,0,62,[],[]
946570726261211136,EvelynxPrime,0,1,0,0,0,137,[],[]
102795611,ConnorJClark,2,0,0,2,0,565,[],[]
967854223328100352,ThomasL57120831,0,0,0,0,0,261,[],[]
1338664389080018952,z8TajXIpd5frXOE,0,1,0,0,0,13,[],[]
344864021,GratsComin,30,0,1,29,0,835,[],[]
585213787,ErichTkeld,3,1,0,3,0,204,[],[]
883819842259656704,chadthundercuck,2,0,1,1,0,31,[],[]
13203932,scottmarshall,0,0,0,0,0,688,[],[]
848173550,joshigoods,4,0,0,4,0,812,[],[]
17740751,tristanzimm,1,0,0,1,0,268,[],[]
1237999754,KurtsCurtQuips,0,0,0,0,0,218,[],[]
2794136608,FloFloSeal,22,1,3,19,0,527,[],[]
1319445411883585537,TheRedMenaceOK,3,1,0,3,0,501,[],[]
1098039620112183296,grump666,2,0,0,2,0,57,[],[]
1034630292382932997,crescentflight,3,1,0,3,0,1629,[],[]
75403792,ginsengity,27,5,3,24,0,8965,[],[]
144950391,RitcheyLogan,11,1,0,11,0,192,[],[]
481799187,aubbero0o,0,0,0,0,0,137,[],[]
172220246,NotoriousRED,6,3,0,6,0,1585,[],[]
1209999349201199105,imbecil_random,3,0,0,3,0,340,[],[]
243291372,BlueTrooth,0,0,0,0,0,3435,[],[]
1021320103898443776,weather16342362,0,0,0,0,0,158,[],[]
1044311935435632643,DreDay___,0,1,0,0,0,96,[],[]
15845655,HaroldSipe,3,0,0,3,0,809,[],[]
271231824,turan_o,1,0,0,1,0,874,[],[]
76331792,hiyo_hairyheart,19,34,4,15,3,2948,[],[]
39977784,CHaze77,13,0,3,10,0,730,[],[]
1264265568825290752,BuddyWoodson,0,0,0,0,0,44,[],[]
1118929978429624321,conspiratorbot,0,0,0,0,0,19,[],[]
15275828,Alyricana,5,3,0,5,0,710,[],[]
609101734,SnaxwellSays,1,0,0,1,0,159,[],[]
814213388356222976,ErlingWeiseth,0,0,0,0,0,11,[],[]
1025755706174124032,OttenbergEve,24,0,5,19,1,3735,[],[]
141196828,MarshallSbar,12,4,0,12,0,12439,[],[]
273689112,DJWilderness,25,5,3,22,0,16405,[],[]
84691192,Sheepthemoon,2,0,0,2,0,1608,[],[]
3636017961,banques_,13,1,0,13,0,178,[],[]
1282080507203911681,pijoprogre_,1,0,0,1,0,364,[],[]
245673656,abicklefitch,1,0,1,0,1,9,[],[]
991008167688581120,HoffmanHopes,0,1,0,0,0,1608,[],[]
242895427,ohheysimone,0,0,0,0,0,610,[],[]
17005421,bodhigrrrl,6,0,0,6,0,1122,[],[]
811977972546572289,CollinYourbs,46,15,1,45,0,6939,[],[]
4534291,jimcollins,1,0,0,1,0,2296,[],[]
929526209368723456,LaborwaveCCCP,6,0,0,6,1,8486,[],[]
989007132371513345,Victoria_Aloe,1,0,0,1,0,84,[],[]
779705101527187456,JohnTeufelNYC,1,2,0,1,0,1414,[],[]
748711707913052161,Matahar38044059,0,0,0,0,0,662,[],[]
3351040515,AnthonyMRoberto,19,3,0,19,1,1546,[],[]
1313635662,pipinthepenguin,0,0,0,0,0,37,[],[]
914095881690996736,Mr_CPOM,155,16,51,104,11,8473,[],[]
1336576403769229312,rwnj_i,1,0,0,1,0,17,[],[]
2854652293,candykane1124,1,0,0,1,0,1610,[],[]
51884939,richjmadrid,22,5,1,21,0,4440,[],[]
139634064,FauxRealER,0,0,0,0,0,145,[],[]
203019975,BarDkn,5,1,1,4,0,1980,[],[]
225901671,411Regan,11,5,0,11,0,2726,[],[]
4851930087,lgretton2000,0,2,0,0,0,14,[],[]
776724415279091713,RobertCReece,1,0,1,0,0,2499,[],[]
124018027,Dreamweaver198,0,0,0,0,0,133,[],[]
602070974,andreCJoz,0,0,0,0,0,404,[],[]
1331211212340613121,MisterLeaves,3,1,0,3,0,1429,[],[]
2765491,snowdeal,1,1,0,1,0,520,[],[]
413502727,MVPizzle,5,1,0,5,0,817,[],[]
288491327,MattBlagg,0,2,0,0,0,492,[],[]
2432942864,trillietitan,1,2,0,1,0,114,[],[]
39076347,justinlife,0,1,0,0,0,184,[],[]
200626185,MtlPhotog,0,0,0,0,0,222,[],[]
456255014,ConorBronsdon,13,3,1,12,1,3214,[],[]
29444143,Jacksoneem,7,2,0,7,1,107,[],[]
2328413720,ethan_mud,21,1,1,20,0,365,[],[]
149961375,DrewciferCDXX,2,0,1,1,0,178,[],[]
1285104865,stenderstender,0,0,0,0,0,1125,[],[]
923238346477928448,danielrupp12,0,1,0,0,0,203,[],[]
1692703842,ZacCollum,1,0,0,1,0,117,[],[]
936689498297196551,cherryboyriots,1,1,0,1,0,117,[],[]
704459578264522752,JeremyJamesBGT,0,0,0,0,0,142,[],[]
108332005,teresaeder,6,1,0,6,1,4129,[],[]
1283099107595300865,sextuplenice,2,2,1,1,0,1180,[],[]
98183151,hermoneyness,6,1,1,5,0,10225,[],[]
897533388306952192,CarboRaider,1,0,1,0,0,852,[],[]
2241439621,classicryan17,16,2,0,16,0,1460,[],[]
1362255673,animikiigizheb,1,0,0,1,0,97,[],[]
322917990,LZR5,1,0,1,0,0,79,[],[]
707336778089271296,gsnodd78,2,0,0,2,1,813,[],[]
1215309022091411456,spotnewstv,0,0,0,0,0,602,[],[]
758409360691388416,SPRKLBB,1,0,0,1,0,116,[],[]
824253931,cubefag,4,0,0,4,0,132,[],[]
415838996,le_pateau,6,1,0,6,0,419,[],[]
367821422,MHGtweet,11,1,2,9,0,3503,[],[]
18969626,dbo1300,0,0,0,0,0,20,[],[]
2232254966,C0lorStream,3,0,0,3,0,306,[],[]
865591365324775424,MichaelMaloneE2,0,0,0,0,0,2,[],[]
198006478,seaweedanxiety,16,4,0,16,0,1260,[],[]
1010998045268377600,KatherineTodd69,0,0,0,0,0,1120,[],[]
1016615099459624960,ProfNaeemRaza,10,0,7,3,0,157,[],[]
1158782402241499137,resistance2p0,18,2,0,18,1,2663,[],[]
2254449818,TheRealSamCeron,2,1,0,2,0,101,[],[]
1291508386081775616,AlizeeRenault,69,17,0,69,1,1825,[],[]
962052526659944450,FanLTB,0,0,0,0,0,6,[],[]
883442809,moore2score,4,1,0,4,0,936,[],[]
974444598738243590,sandsrb,0,1,0,0,0,53,[],[]
795950214951669760,Jack_Mrgln,7,0,0,7,0,3379,[],[]
441025617,lupogdg,1,0,0,1,0,685,[],[]
2954655566,juniorhoncho,1,0,0,1,0,595,[],[]
949277218533867525,__vlnrbl,0,0,0,0,0,40,[],[]
2903863545,Trauma_Pagaza,0,0,0,0,0,141,[],[]
1429212559,DickCheneyFacts,1,0,0,1,0,2009,[],[]
1687137865,jxcxbrxss,0,2,0,0,0,133,[],[]
927711635556401152,dillbifilippo,1,0,0,1,0,81,[],[]
615162802,M1Clark,0,0,0,0,0,49,[],[]
722496001433608192,anthonyscountry,9,2,0,9,2,538,[],[]
484387366,LangfordAndrew,0,1,0,0,0,268,[],[]
24003640,lizzieshore,2,1,0,2,0,906,[],[]
21431729,NoraBrup,26,5,6,20,2,7385,[],[]
465682953,twtrPAD,4,1,0,4,0,17589,[],[]
459876432,rogertansey,110,22,8,102,3,29248,[],[]
831508471828713472,DougHow18099683,20,5,3,17,2,138,[],[]
1074227108,dreamoforgonon,33,3,1,32,0,20834,[],[]
764874433,ak_hoffman,0,0,0,0,0,688,[],[]
4780781144,lightworkerkay,0,0,0,0,0,43,[],[]
77795631,DevTwoThousand,7,2,0,7,0,1811,[],[]
37726215,lowayne,1,2,0,1,0,951,[],[]
40804983,meghancnyc,0,2,0,0,0,1702,[],[]
911278122758221824,mumydadi007,0,0,0,0,0,1,[],[]
64717523,NYCGRIFF,1,3,0,1,0,5777,[],[]
1266249478886965248,arknewman1,0,0,0,0,0,15,[],[]
2402274596,heiwabokecrisis,1,1,0,1,0,137,[],[]
1069600795,perez_inc,0,0,0,0,0,8,[],[]
767334895,alancarawan,0,0,0,0,0,330,[],[]
18913728,SamRMoore,0,0,0,0,0,213,[],[]
988571492190482432,PjJstone,0,0,0,0,0,4,[],[]
1009154425355689985,doinkdofika,0,0,0,0,0,1264,[],[]
1291573086022639617,BotSatire,6,1,0,6,1,354,[],[]
1342327206283010048,MidYlf,6,0,0,6,0,1761,[],[]
2325290677,Sale6891699293,1,0,0,1,0,857,[],[]
1262388668901330947,hiimpaul33333,1,0,0,1,0,7,[],[]
2923343713,scarredempire,3,0,0,3,0,290,[],[]
137431498,Rontowski,8,1,0,8,0,3595,[],[]
2536305951,Pinkroommusic,0,0,0,0,0,239,[],[]
258915638,2meek4drugs,1,1,0,1,0,253,[],[]
967218240853364736,iseeghosties,3,0,0,3,0,124,[],[]
1720110008,vaper_dads,0,0,0,0,0,209,[],[]
823628370239856641,georgeleach22,0,0,0,0,0,4,[],[]
748858454111125504,FakieMcFakeface,0,0,0,0,0,300,[],[]
1293948623286394883,SuburbanAmerica,0,0,0,0,0,8,[],[]
733409178341908481,praisebees,2,0,0,2,0,40,[],[]
562474604,11_11GodIsLove,0,0,0,0,0,51,[],[]
749267122321256448,WarOnThoughts,0,0,0,0,0,1119,[],[]
1062510213918449664,Jackasaurus3,650,103,113,537,32,38392,[],[]
985184398004969472,TedJone00884273,0,0,0,0,0,1088,[],[]
983531271749070848,gaybasque,5,0,1,4,0,2377,[],[]
1125532367056015361,alwysfaded,0,0,0,0,0,66,[],[]
344442463,AlexYablon,0,1,0,0,0,8783,[],[]
1249740571763257350,PersistentOne3,108,10,10,98,1,2428,[],[]
3159888878,DahliaZahava,217,3,10,207,0,19054,[],[]
478269968,WhitesLike,6,0,0,6,0,6204,[],[]
1303157157135814657,keetie_g,0,0,0,0,0,6,[],[]
15349002,kevinrfree,18,1,0,18,0,7584,[],[]
20030146,JohnReidy303,75,6,3,72,1,2342,[],[]
1293951285247594496,phillyblackpill,0,0,0,0,0,205,[],[]
218982471,Jimboleem,2,0,0,2,0,3931,[],[]
169360058,k_shep_mt,0,0,0,0,0,94,[],[]
1171500456,garliquorice,2,0,0,2,0,223,[],[]
1039037100,HKeryl94,8,0,0,8,0,622,[],[]
2777967191,mooooojen,8,0,3,5,0,1033,[],[]
104758530,jjjove,8,2,0,8,0,4730,[],[]
23106258,JonBershad,19,0,2,17,0,7132,[],[]
1146602808,scarletbitchboi,1,0,0,1,0,256,[],[]
377527942,Pat_Killpatrick,0,0,0,0,0,58,[],[]
1254958803050811393,redling_s,1,0,1,0,0,1506,[],[]
865114405792501761,aismallard,17,3,1,16,2,729,[],[]
887459156143353856,ChuckWagon645,1,0,0,1,0,337,[],[]
825055938377773056,BittyCharms,22,1,1,21,0,3559,[],[]
2973824018,silk_laurent,8,3,1,7,0,1463,[],[]
269581983,BlueBirdChatter,0,1,0,0,1,552,[],[]
42599288,Daskal_Kamce,0,0,0,0,0,494,[],[]
24752758,afkiff,1,0,0,1,0,1756,[],[]
29280851,NickIzumi,3,2,0,3,0,259,[],[]
614581715,AnneDragonetti,3,1,0,3,0,118,[],[]
253502733,kerravon86,0,0,0,0,1,61,[],[]
45950979,Yoshichao,1,1,0,1,0,163,[],[]
2887251898,burrito_bushido,3,0,1,2,0,128,[],[]
1333551935950041095,ALEXAND06217087,0,0,0,0,0,3,[],[]
1335391613921718278,WafflesMagee2,4,0,1,3,0,6,[],[]
1272329158153076736,Thehmbohnes,1,0,0,1,0,1391,[],[]
548631031,library_hoe,10,0,0,10,0,552,[],[]
2283851168,thelesmurray,1,0,0,1,0,82,[],[]
824913358063153152,stupid_hat,1,0,0,1,0,288,[],[]
129272454,brendaanndixon,0,0,0,0,1,135,[],[]
495114951,JohnGabriault,0,0,0,0,0,0,[],[]
54191684,kirahfaye,0,0,0,0,0,221,[],[]
588660387,lertylardner,1,0,0,1,0,135,[],[]
14650626,stefanthinks,37,7,4,33,2,16080,[],[]
1011054103638749184,LeoJO001,1,0,0,1,0,28,[],[]
2194551815,baeveryy,3,1,0,3,0,140,[],[]
1325997846,DeckofCarter,25,4,0,25,0,3605,[],[]
1291065884371554306,selmathereboot,9,1,0,9,0,165,[],[]
34122510,GabiSpeaksNow,1,0,0,1,0,326,[],[]
716094065,kingofthatrilll,4,0,0,4,0,132,[],[]
49544265,SobeWanKenobi,4,0,0,4,0,1427,[],[]
952664728999952384,ghostbugg,4,0,0,4,0,108,[],[]
192809751,LeMontPierreC,0,1,0,0,0,1329,[],[]
786065401948045312,KrissieTX,57,2,2,55,0,5629,[],[]
100156438,jakealucas,2,0,0,2,0,586,[],[]
1188011161,bbbbbbbennnnnn,0,0,0,0,0,477,[],[]
14689199,waynecurtis,13,1,0,13,0,7162,[],[]
1224546660791017472,Unkn0wnShadow,4,1,0,4,0,855,[],[]
1285663255713574912,Scummy_Says,0,0,0,0,0,29,[],[]
7751612,mixdup,0,0,0,0,0,174,[],[]
1324483512217591809,SqirlyWorld58,0,0,0,0,0,1111,[],[]
17259137,LiberalsAreCool,0,0,0,0,0,2637,[],[]
797576025815261185,Brocktooon,1,1,0,1,0,451,[],[]
15791820,LuigiThirty,8,2,0,8,0,3420,[],[]
1305581071589834758,AnonymousTST,33,5,0,33,1,842,[],[]
2357601397,Cendyen,142,21,7,135,1,171,[],[]
1243240400317558784,UnderbellyE,0,0,0,0,0,331,[],[]
1342125909202112512,bartadams09,0,0,0,0,0,4,[],[]
54670100,sofaking6,0,0,0,0,0,1269,[],[]
29105288,SandraNavidi,25,8,3,22,0,8299,[],[]
26035351,princewonder,1,0,0,1,0,409,[],[]
340595226,vox_celestial,0,0,0,0,0,161,[],[]
1869204066,jesusisking1948,0,1,0,0,0,365,[],[]
339403469,novaxftw,1,0,0,1,0,302,[],[]
19003095,TrevorBarrios,4,0,1,3,0,62,[],[]
1210783147253649409,R_Threading10,0,0,0,0,0,269,[],[]
1835700481,PejLoaf,2,0,0,2,0,469,[],[]
22080740,DylanLathrop,0,0,0,0,0,3423,[],[]
100606121,Theo_Danes,2,0,0,2,0,1819,[],[]
2863464223,SeekingJustPath,0,1,0,0,0,822,[],[]
13725242,janvds55,0,0,0,0,0,1170,[],[]
2927908741,Cazual_Cazanova,0,0,0,0,0,20,[],[]
3035019406,RMConneely,0,0,0,0,0,503,[],[]
3137465747,sawyjay30,2,0,1,1,0,1631,[],[]
1262652914620923908,Novemberthir,7,0,2,5,0,5095,[],[]
1295772756915687430,LaVillana11,11,0,2,9,0,1266,[],[]
139814021,th0r4g,2,2,0,2,0,28,[],[]
3436557057,Stahlnippel,19,3,0,19,0,769,[],[]
1255531888262995969,HermanniTest,0,0,0,0,0,313,[],[]
345715168,RockoCalavasi,1,1,0,1,0,53,[],[]
177677583,5klp471,0,0,0,0,0,2021,[],[]
3228760827,MMamloki,4,0,1,3,0,693,[],[]
845377852895870976,PennyCarrigan1,2,0,0,2,0,1618,[],[]
1334720105071046659,ogrollermike,0,0,0,0,0,231,[],[]
1204037399669592065,JeffreyDurkin4,0,0,0,0,0,134,[],[]
18903602,Smile4Chomsky,2,1,0,2,0,623,[],[]
1150763832215781376,adam_round_3,6,1,0,6,0,394,[],[]
146618868,benleemusic,3893,181,410,3483,61,40107,[],[]
1330982688526884864,TonyWilks16,0,0,0,0,0,22,[],[]
361409175,SlugRat_,0,1,0,0,0,66,[],[]
756536323457056768,Bianxsee,0,0,0,0,0,33,[],[]
1296361339074555904,jasonmarcelTO,3,0,0,3,0,205,[],[]
1271174710009757696,EnigmaMind1,0,0,0,0,0,1661,[],[]
1222540365435146241,arcey_p,2,0,0,2,0,204,[],[]
1299025447423012864,JamesTweedy19,1,1,0,1,0,780,[],[]
711535010575032321,Supermarket_Ape,1,0,0,1,0,251,[],[]
2525720515,geoffmartello,1,0,0,1,0,218,[],[]
349210782,bimbo____summit,6,0,0,6,0,460,[],[]
1013839524236054528,socialistboomer,77,5,7,70,1,21840,[],[]
3010616274,LucyFerr3,9,0,1,8,0,1978,[],[]
204930105,xojmo,3,0,0,3,0,1386,[],[]
909480152081457152,GrahamCLester,3,0,1,2,0,3596,[],[]
9614422,AndrewCFrancis,3,1,0,3,0,1726,[],[]
998740314469945346,MondayNightRon,0,1,0,0,0,165,[],[]
340463283,CheebaJones,2,0,1,1,0,923,[],[]
2368131661,chodelywilliams,1,0,0,1,0,66,[],[]
162411004,Gryffix,81,10,1,80,1,8983,[],[]
1212950263541059585,prafxis,17,0,0,17,0,4641,[],[]
1188882050129883140,on_da_spectrum,76,3,3,73,0,12191,[],[]
16223941,KevinClamato,4,2,0,4,0,2967,[],[]
104309271,bobclendenin,95,15,8,87,0,18895,[],[]
45456873,LynCKos,9,0,1,8,0,3519,[],[]
218916692,rachiojane,1,0,0,1,0,739,[],[]
1110046626763157504,LibbyMathias5,4,0,0,4,0,86,[],[]
1326714874794180608,AstroboyFM,2,0,0,2,0,535,[],[]
511197028,SerenitySaber,0,0,0,0,0,159,[],[]
141037638,Kim_Buh_Lee,8,1,3,5,1,1901,[],[]
20017835,evanmcmurry,2,0,0,2,0,19770,[],[]
538562897,piratkatt,2,2,0,2,0,853,[],[]
95762059,Kilgoar,1,0,0,1,0,1990,[],[]
871374306139226112,KLV512,0,0,0,0,0,16,[],[]
918000740,sjacobm321,142,11,13,129,2,23907,[],[]
1888109557,zachcherman,2,0,0,2,0,91,[],[]
891620144,bleedwellx,14,3,0,14,0,456,[],[]
1141014624483119105,dont_cancel_me,0,0,0,0,0,35,[],[]
329913473,BrendanSasso,4,1,2,2,0,3684,[],[]
717865807091359744,The_Lucille_,0,0,0,0,0,78,[],[]
1006207773732954112,groenboys,0,0,0,0,0,239,[],[]
65272235,feistybunnygirl,17,1,4,13,0,9186,[],[]
61299354,pbpaste,1,0,0,1,0,818,[],[]
1148611904182587392,CarlosATarin,3,0,2,1,0,275,[],[]
2898039962,Spencer3Johnson,1,0,0,1,0,172,[],[]
58122413,GongSteve,51,4,16,35,1,5846,[],[]
1262400502593183746,ChanelVanHook,2,0,0,2,0,669,[],[]
2883178386,SplitDaWig,15,2,0,15,0,10064,[],[]
2239543908,MelissaOttery,1,1,0,1,0,173,[],[]
235346967,zireaelxintrea,0,0,0,0,0,646,[],[]
2399928805,MJ_Cruickshank,2,0,0,2,0,6762,[],[]
1035885185856888832,diogoalvesmatos,0,0,0,0,0,10,[],[]
1098273901090529280,GammaCas,3,1,0,3,0,1435,[],[]
1032558947327258625,MaryMller19,41,9,0,41,0,3430,[],[]
1267641965069438977,JamesMusbach,0,0,0,0,0,1,[],[]
373585800,VonLinguini,0,0,0,0,0,626,[],[]
226775693,bdavisauthor,12,4,0,12,0,8318,[],[]
3198809179,ImWithTheFBI,1,0,0,1,0,85,[],[]
1250812037418160130,Brendan1617,3,1,0,3,0,663,[],[]
487169480,HARDHEADtur,0,0,0,0,0,362,[],[]
847190222366527488,bittybitbit86,3,0,0,3,0,5817,[],[]
1052798514634272768,BMempesona,0,0,0,0,0,7521,[],[]
126148120,ialsowantasword,2,0,0,2,0,439,[],[]
1002650002097868800,greatsweetleaf,5,2,1,4,1,3791,[],[]
199524865,malicon_,0,0,0,0,0,1,[],[]
246330932,wllroche,0,0,0,0,0,137,[],[]
747819338758037504,mutiebeauty,1,0,0,1,0,297,[],[]
920419043840053249,CallieBeaulexus,0,0,0,0,0,2713,[],[]
2473765316,CharltonMen,0,0,0,0,0,6972,[],[]
2635881203,cassidyyhennen,1,0,0,1,0,552,[],[]
190751909,NarodRossia,10,10,7,3,2,5844,[],[]
1300107013129752576,UhtredDemSlayer,0,0,0,0,0,15,[],[]
379456814,DkBell0,4,0,0,4,0,196,[],[]
1089189427967082502,bobby_paulk,8,2,1,7,0,11654,[],[]
27581094,Ottersfriend,0,0,0,0,0,269,[],[]
1262094863442407424,hopeanyway__,2,2,0,2,0,17,[],[]
85503665,Option_Zero,5,0,1,4,0,793,[],[]
20693709,spikeatone,0,0,0,0,0,951,[],[]
1136065525367181312,DebbieDoukakis,0,0,0,0,0,736,[],[]
1278561307,jaaryk,8,1,1,7,0,97,[],[]
3852781037,anxiousmeatsuit,6,0,0,6,0,146,[],[]
82950262,leslietheysay,0,0,0,0,0,264,[],[]
30687343,iyamiyam,3,0,0,3,1,2659,[],[]
287891346,CarltonHuffman,1,1,0,1,0,1908,[],[]
1256505864099434496,PepeWingman,0,0,0,0,0,549,[],[]
1336727132047814657,GrandSachoir,0,1,0,0,0,1337,[],[]
72610334,briandaly473,1,0,0,1,0,2512,[],[]
1236040296292585479,TheyThemItalian,13,0,1,12,0,1202,[],[]
719868644,MikaPeltokorpi,0,0,0,0,0,850,[],[]
4855273126,ChadFarrenburg,3,7,1,2,1,291,[],[]
4794691,conches,0,0,0,0,0,1304,[],[]
274707404,keatonkristofer,0,0,0,0,0,1083,[],[]
213689248,DoctorYasmin,44,2,5,39,0,73575,[],[]
17740063,bosqmusic,6,0,0,6,0,1931,[],[]
1150121514617860097,justrying4,1,0,0,1,0,12,[],[]
306553598,LisaLBellamy,1,0,0,1,0,940,[],[]
10464092,taxtweet,0,0,0,0,0,11590,[],[]
1109042992504025088,Wilkensonknaggs,0,0,0,0,0,20,[],[]
15988705,dgg246dgg,0,0,0,0,0,406,[],[]
973941909507985408,ChristosRising,0,1,0,0,0,339,[],[]
1204426159175286785,disruptorbot,0,0,0,0,0,16,[],[]
37932326,renatagames,14,1,1,13,0,8787,[],[]
763746877531561984,tomatoma252,1,0,0,1,0,67,[],[]
788476683456221184,alburquenniense,1,0,0,1,0,278,[],[]
592031486,das_munch,1,1,0,1,0,592,[],[]
322275556,OutcastEst1992,0,0,0,0,0,1257,[],[]
1279838665884094465,tara25_s,7,0,1,6,0,2220,[],[]
947828772362956800,jarue369,50,6,5,45,3,10268,[],[]
84012461,exardurdles,0,0,0,0,0,183,[],[]
1189878060234883072,EspritdeCorp258,0,0,0,0,0,964,[],[]
1284699768711778304,GRealistico,0,0,0,0,0,18,[],[]
193838010,Riccardo_Piazza,0,0,0,0,0,346,[],[]
19219499,bhepp234,0,0,0,0,0,314,[],[]
1201608199,wakeupengland1,0,0,0,0,0,778,[],[]
49338583,Cruisoring,18,0,5,13,1,24,[],[]
111968511,chocolatan_z,1,0,0,1,0,819,[],[]
396070101,silentsonata13,0,0,0,0,0,101,[],[]
1340623354643017728,hugh_jasoll,0,0,0,0,0,0,[],[]
847031689322926081,Ex101JC,0,0,0,0,0,298,[],[]
33448277,videobobbo,0,1,0,0,0,259,[],[]
18220453,rall0r,6,0,0,6,0,532,[],[]
386814350,Critical_FTW,6,0,1,5,0,5571,[],[]
172417678,Discocheats,1,0,0,1,0,97,[],[]
23986911,a_invi,0,0,0,0,0,705,[],[]
886398296146706432,davenewworld_2,8669,192,1443,7226,153,191614,[],[]
982383266249527296,YMarieCarter,5,3,0,5,1,1429,[],[]
6418372,sdp,3,0,1,2,0,6173,[],[]
1224504365458870274,_r_e_j_,2,0,0,2,0,187,[],[]
1183533703550648320,orianarchy,0,0,0,0,0,4,[],[]
100880543,LiberalMmama,467,23,58,409,3,41046,[],[]
2336049481,bemorefocused,0,0,0,0,0,131,[],[]
1276533589077667841,mariehi19,0,0,0,0,0,103,[],[]
42355904,olisbahari,0,0,0,0,0,0,[],[]
845812857518211073,midsomerplots,42,0,4,38,0,10154,[],[]
990738696017137664,FerrazzanoJay,79,13,16,63,0,7789,[],[]
20514908,janecannery,0,0,0,0,0,156,[],[]
1919561593,shane25873,18,2,3,15,0,8345,[],[]
1041527088212193280,DeplorableMik16,1,0,0,1,0,1996,[],[]
20758263,LuvLibertyPeace,0,0,0,0,0,1358,[],[]
29416777,strayney,7,2,3,4,0,851,[],[]
1077500174728130561,CarterSchoolcr1,0,1,0,0,0,73,[],[]
753565046156824576,tsukinowa1262,0,0,0,0,0,522,[],[]
1231034812573478914,ophelia99999,1,0,0,1,0,452,[],[]
1074861900,mattelgrande,5,0,0,5,0,1626,[],[]
1066850311,midwestfinn,0,0,0,0,0,636,[],[]
3238017595,HebrewMexican,0,0,0,0,0,1015,[],[]
1214770150169305088,SegaCD8,6,0,0,6,0,541,[],[]
2334143682,thebVAPES,2,0,0,2,0,255,[],[]
1258190822081732609,RegrettableDec1,0,0,0,0,0,219,[],[]
1309784233,VeronicaAwakens,6,1,1,5,0,525,[],[]
1325141774860390401,DuhManInMyMind,0,0,0,0,0,122,[],[]
1279046662548152321,dermotfenster,0,0,0,0,0,70,[],[]
1463587219,chiefkweev,8,0,0,8,0,517,[],[]
820009956569190400,Carolyn81933632,1,0,0,1,0,1410,[],[]
1107353912908996608,MincedGinger,2,0,0,2,0,19,[],[]
4926315899,spamcoram,5,1,0,5,0,124,[],[]
2574104766,xbluedream89x,0,0,0,0,0,28,[],[]
14882215,cultxpt,1,0,0,1,0,420,[],[]
1295064923685310464,WontCaveDave,14,0,4,10,0,25702,[],[]
936794497115148288,RED_RAlN,0,0,0,0,0,966,[],[]
1273429287530618880,cancer_blood69,12,0,1,11,0,2065,[],[]
16333411,woojo,1,0,0,1,0,154,[],[]
29362737,OhSoLivePHIve,0,0,0,0,0,579,[],[]
52022804,rehydraters,7,1,0,7,1,1435,[],[]
2396903010,derangedweenie,3,0,0,3,0,134,[],[]
751236099100467201,AZCurlyGurl,0,1,0,0,0,19,[],[]
839894998715936773,therealltlkrow,11,7,1,10,0,14402,[],[]
131365495,RETINKS,0,1,0,0,0,1454,[],[]
350317593,ZombieLaika,1,1,0,1,0,794,[],[]
184256235,gr8n8tr0n,2,0,0,2,0,1998,[],[]
716788160760512512,chromesandwich,9,0,0,9,0,798,[],[]
1198054928633065472,GenuineHippie,0,0,0,0,0,122,[],[]
14769495,KEBrightbill,31,1,0,31,0,11355,[],[]
3233490266,dgreenw829,3,1,0,3,0,3185,[],[]
1335458316,freckldfeminist,0,0,0,0,0,177,[],[]
81026888,lapittenger,19,1,0,19,0,3255,[],[]
927756114,NGLP124,2,0,0,2,0,1192,[],[]
405334715,EphraimOvKnives,23,2,0,23,0,2914,[],[]
19268619,nuns_on_film,33,8,0,33,0,6542,[],[]
1290603663988121600,2020Mmcm,0,1,0,0,0,8,[],[]
238338163,HapsburgJaw,0,1,0,0,0,610,[],[]
823583332780965889,firedup79,22,2,3,19,1,6684,[],[]
17071440,Brophensteen,0,1,0,0,0,140,[],[]
21175707,Kalieezchild,7,0,0,7,0,1638,[],[]
276356682,greyman223,0,0,0,0,0,447,[],[]
1339215007242805248,LesterS37178154,0,2,0,0,0,35,[],[]
368083707,carothersp,3,0,1,2,0,118,[],[]
1326502183190327296,Megan94302616,0,0,0,0,0,1,[],[]
147731146,symptomaddict,11,3,1,10,0,1294,[],[]
1164328966032773120,Bobfromnorcal,4,0,1,3,0,258,[],[]
1163115080181063681,cdb224,0,0,0,0,0,957,[],[]
805286341558734848,twentymaster32,0,0,0,0,0,4016,[],[]
1216673964,MAJJimR,0,0,0,0,0,1623,[],[]
841766886,processanalyzer,1,0,0,1,0,1107,[],[]
800129117794377728,amiokidoki,9,0,0,9,0,655,[],[]
1125995070639837184,artonchain,0,0,0,0,0,1488,[],[]
4251536475,Fr_Robbe,44,0,0,44,0,3059,[],[]
726172551974637569,steelergal126,0,0,0,0,0,3885,[],[]
1325154634898477056,TCovid1984,12,1,3,9,1,2770,[],[]
1312233347628892160,oakwillowelm,0,0,0,0,1,47,[],[]
107281820,onthebus17,0,0,0,0,0,1189,[],[]
731482849921122305,AecMike,9,3,0,9,0,264,[],[]
836910818,cat_i_e,2,0,0,2,0,1833,[],[]
33279971,gnarlydudes,4,0,0,4,0,446,[],[]
18534889,BillCody,3,0,0,3,0,16076,[],[]
1620573349,Literallywiccan,2,0,0,2,0,190,[],[]
710472373078790145,pkpaddaddy,0,0,0,0,0,803,[],[]
64253089,anyankajenks,1,0,0,1,2,363,[],[]
30901658,WillResistAdmin,1,0,0,1,0,6400,[],[]
878774382,PatrickNix,0,2,0,0,0,535,[],[]
1888139251,shhall35,1,0,0,1,0,97,[],[]
1254469595924238336,PirateoftheNor1,0,1,0,0,0,5,[],[]
48227953,rmt834,0,0,0,0,0,228,[],[]
45646060,_Zeets,218,1,27,191,4,51302,[],[]
1700208541,tony_hladik,0,0,0,0,0,265,[],[]
490782941,StrykerSpurlock,0,0,0,0,0,687,[],[]
1319479517283377154,dvrango_stan,0,0,0,0,0,58,[],[]
814741249282441216,Rehman05627709,2,0,2,0,0,9,[],[]
1104285536,jakm01,0,0,0,0,0,2070,[],[]
135116783,TrumptonRiot,0,1,0,0,0,182,[],[]
2973846123,ktweaves,11,1,0,11,0,380,[],[]
49055358,tyler_is_comedy,8,1,0,8,0,1064,[],[]
885440208,fembotxx,0,0,0,0,0,462,[],[]
1220042729146765312,AhmadRami80,0,0,0,0,0,281,[],[]
778323375479488512,11mmyJohns,5,2,0,5,0,345,[],[]
1338737891892224001,DolphinsDogmata,1,0,0,1,0,4,[],[]
2266235347,mmaier65,6,1,0,6,0,198,[],[]
172697742,Quaro75,0,0,0,0,0,158,[],[]
14336851,pegitha,0,0,0,0,0,712,[],[]
207847766,hjrrockies,1,0,0,1,0,761,[],[]
903002488915333122,JodeneRdc,14,1,4,10,2,9471,[],[]
831296253610905600,skeleton_dandy,5,0,0,5,0,1058,[],[]
4791981230,feline_ten,0,0,0,0,0,537,[],[]
8276952,STEVEPMP,7,2,0,7,0,27909,[],[]
193906765,RocksteadyRicky,85,0,13,72,0,8775,[],[]
326004902,samtheawe,1,0,0,1,0,1702,[],[]
1323665958540582912,KaitlinSmith11,1,0,0,1,0,1,[],[]
2382106993,MollyMcKew,500,9,55,445,1,164627,[],[]
3098710146,blue_scotty,9,2,0,9,0,943,[],[]
1138018338410553345,NeikoCat,1,0,0,1,0,509,[],[]
20723754,rivetrivet,1,0,0,1,0,427,[],[]
1325252304921010176,GaryKasparov7,0,1,0,0,0,21,[],[]
2842318371,bbentzftr,0,0,0,0,0,149,[],[]
1036000976094867469,OmniScepticus,1,0,0,1,0,253,[],[]
294043056,psdrcgschwarzkc,0,0,0,0,0,1588,[],[]
1146842370446462976,lambdao_,2,0,0,2,0,619,[],[]
239480300,PayneThayer,1,0,0,1,0,552,[],[]
859093928624230400,8BitVentilator,4,1,0,4,0,189,[],[]
2479203790,PamBorgelt,23,5,3,20,2,155,[],[]
294326953,warholskidd,3,0,0,3,0,574,[],[]
1336915575927427077,CollinsLedger,4,0,1,3,1,1855,[],[]
3078904446,Totallytar,0,0,0,0,0,11,[],[]
2557304533,YoungerPope,0,0,0,0,0,308,[],[]
945256737296211968,estrodiol,113,7,32,81,0,1968,[],[]
1133701,doctorparadox,0,0,0,0,0,9858,[],[]
95982820,lon_sl,0,1,0,0,0,2157,[],[]
170505587,Ben_Samson,1,0,0,1,0,504,[],[]
14903327,timhwang,14,1,0,14,0,17246,[],[]
3972554675,DebMacdonald38,6,0,2,4,0,18631,[],[]
429520869,crieslikeaboy,13,0,0,13,0,334,[],[]
2273505030,Donnz399,1,0,0,1,0,4685,[],[]
726173167274876928,GioGiugiaro,0,1,0,0,0,1151,[],[]
1299062539108659203,lesaaron3,0,1,0,0,1,73,[],[]
1330816180332998658,GGmilgram,15,11,0,15,0,6720,[],[]
559709206,EBOlady,0,0,0,0,1,785,[],[]
82519954,profdaly,1,0,1,0,0,1055,[],[]
875653941437923329,boglin_scrub,1,0,0,1,0,262,[],[]
215051785,drcstevens,0,0,0,0,0,165,[],[]
1291105548969160705,JG_McCarthy,3,0,0,3,0,63,[],[]
15599904,melsweet,0,0,0,0,0,375,[],[]
508333384,TyroneWalden,2,0,1,1,0,321,[],[]
66857886,haydensmith_92,0,0,0,0,0,341,[],[]
132338987,BioshockLGP,7,4,0,7,0,1207,[],[]
786311659253923840,100yearsofskin,0,0,0,0,0,181,[],[]
1294511698108243974,JC1oAxgs4D6D3kc,476,5,58,418,9,53001,[],[]
4407693400,MBMOSEL,0,0,0,0,0,102,[],[]
24678732,cindorf,0,0,0,0,0,202,[],[]
928766506732793856,AgentBraise,1,0,0,1,0,76,[],[]
212820561,longshipdriver,0,1,0,0,0,1653,[],[]
3226947918,zo_sanz,1,2,0,1,0,774,[],[]
734451042667102208,kb_katey,0,0,0,0,0,279,[],[]
1151967455780245504,michael70490778,0,0,0,0,0,1,[],[]
2659669340,BJFrith,3,0,0,3,0,2988,[],[]
8733162,Beriya,254,0,55,199,0,3889,[],[]
133738109,Krisehandtering,1,0,0,1,0,2709,[],[]
22196531,Judah_Radd_IFLC,3,0,0,3,0,267,[],[]
1245796572593618950,iamthepropane,0,0,0,0,0,94,[],[]
452447773,MARKKable,0,0,0,0,0,231,[],[]
834718036070371328,nyhedsmikset,0,0,0,0,0,20,[],[]
916813641231556608,MGInvestigates,4,1,0,4,0,326,[],[]
20106427,DiWebster,4,3,0,4,0,1541,[],[]
1274386195439550464,atothe_d,10,0,0,10,0,2459,[],[]
888832966163484672,Stanford_lands,1,1,0,1,0,605,[],[]
46015350,CNBurn,0,0,0,0,0,43,[],[]
379059260,CherryNocti,3,2,0,3,0,751,[],[]
1210561670654939136,MagnumForce12,5,3,0,5,0,442,[],[]
1270359426097188869,TheMotive9,0,0,0,0,0,28,[],[]
60168060,eandh99,0,0,0,0,0,859,[],[]
948298528987557888,lv2b2stpng,0,0,0,0,0,9,[],[]
1245635488083402752,AnHourPastPaid,2,0,0,2,0,303,[],[]
363516662,WhiskeyInCesaro,0,0,0,0,0,55,[],[]
935633829137670155,_deadhand,10,2,0,10,0,311,[],[]
14075679,jawshchevyvan,1,0,0,1,0,281,[],[]
810550615348748289,The_Hostager,3,1,0,3,0,94,[],[]
1050106151281577984,johnlop27832009,0,0,0,0,0,51,[],[]
1337985762239791105,OPEN_THE_LABS,0,0,0,0,0,245,[],[]
82908417,get24maizenblue,1,3,0,1,0,224,[],[]
998313927359508480,eberhunden,4,0,0,4,0,1086,[],[]
279390084,YourAnonNews,3893,119,242,3651,71,8042913,[],[]
893472533407821824,Siyao_Hu,0,0,0,0,0,45,[],[]
1069627670290489348,ataoksuave,2,0,0,2,0,268,[],[]
1231742476282523649,ElmerEpp1,4,0,1,3,0,3273,[],[]
517101711,yabbietol,1,0,0,1,0,1299,[],[]
590363819,MikeGormly,0,0,0,0,0,70,[],[]
67473159,Sinnistarr,0,0,0,0,0,116,[],[]
14211980,kmfpl,0,0,0,0,0,565,[],[]
298015007,RemakingManhood,40,2,5,35,0,16060,[],[]
26352872,FloridaAtheist,1,1,0,1,0,9099,[],[]
248469841,ToleChurman,5,3,1,4,0,179,[],[]
169162654,Delescluze101,1,0,0,1,0,696,[],[]
228789646,LastOTinSpace,0,0,0,0,0,158,[],[]
435249107,ATXrepublic,0,1,0,0,0,446,[],[]
1095693333194817536,printsminions,3,0,0,3,0,70911,[],[]
1272319346270928902,1sttsurugi,3,0,0,3,0,429,[],[]
53706374,TreborFarg,0,0,0,0,0,38,[],[]
101868277,FinnFeniks,1,0,0,1,0,192,[],[]
908231750,an_ali_a_day,0,0,0,0,0,81,[],[]
18885134,VinceRugari,99,10,5,94,1,16625,[],[]
19693970,PonderingPrinc,2,0,0,2,0,5471,[],[]
18577428,FullNameXtian,0,0,0,0,0,164,[],[]
806577451849621504,cool_lich,1,0,0,1,0,723,[],[]
4804452380,americastribe,0,0,0,0,0,847,[],[]
549733988,joesox04,1,0,0,1,0,262,[],[]
773476804547874817,fuzimaru151,2,2,0,2,1,1723,[],[]
1308240683392737280,762x39FMJ,1,2,0,1,0,142,[],[]
715913669826191360,callousdaoboys,46,3,0,46,0,4493,[],[]
1027601280,CheryldeeHuddle,0,0,0,0,0,479,[],[]
771265036484349952,saucytruffle,0,1,0,0,0,179,[],[]
280283321,Yarumasi,4,0,0,4,0,1343,[],[]
4641344609,Outer_Zevin,4,0,1,3,0,217,[],[]
243965913,TheAdamGoldberg,49,4,2,47,2,32557,[],[]
4126880173,lykanprince,1,1,0,1,0,461,[],[]
931240267226714112,scottkernest,37,3,3,34,1,3272,[],[]
1243560408025198593,MeidasTouch,56215,674,11486,44729,1282,780984,[],[]
1044733751991959552,MilkHold,0,0,0,0,0,400,[],[]
20735369,GeneFrienby,4,0,0,4,0,2901,[],[]
829849847184252928,stinkythinktank,15,3,2,13,0,3956,[],[]
2281181600,PresidentDawg,50,8,2,48,2,27361,[],[]
1193191456892215296,LimaLimaFoxtrot,1,1,0,1,0,173,[],[]
144213594,miguellean,11,2,0,11,0,566,[],[]
16789745,JRoche3MR,1,0,0,1,0,1374,[],[]
2989969013,chooch_1080,1,0,0,1,0,178,[],[]
1287438601412907015,Leftylooseydavy,4,0,0,4,0,138,[],[]
607176400,SFKteuton,0,0,0,0,0,267,[],[]
1326828863771582464,sereveiller2021,16,2,4,12,0,12846,[],[]
32823974,ideafaktory,1,0,1,0,0,4175,[],[]
753642516021469184,realXanderXjork,17,1,3,14,0,15362,[],[]
2987491628,bussyboiss,3,1,0,3,0,818,[],[]
822162224341024768,SandraBHaynes45,0,1,0,0,0,1189,[],[]
1090948668,JamesFolta,6,0,0,6,0,4532,[],[]
1240161471289364482,Hellyacrypto,0,0,0,0,0,228,[],[]
1286165200429883392,aspiringburner,0,0,0,0,0,778,[],[]
1077919192253222914,ezylvr,3,1,0,3,0,12518,[],[]
