User ID,User Name,Node_weight,Reply Count,Retweet count,Like Count,Quote Count,Followers Count,FOllowerID,Follower name
95296534,troj21,1,0,0,1,0,2179,[],[]
1308197623266979843,SAH79501009,0,0,0,0,0,989,[],[]
240958829,mom2JPbaseball,1,0,0,1,0,1046,[],[]
878779466780213252,fakeJoeMc,0,0,0,0,0,4,[],[]
1329154307669716992,ArmenThomasian,0,0,0,0,0,0,[],[]
42971403,DavidBegnaud,212,33,85,127,15,267198,[],[]
1276898787835940865,RealDrTruth,0,0,0,0,0,492,[],[]
2735589765,jcmaddux,3,0,2,1,1,1042,[],[]
1251133621076811776,GeeteAnkur,1,0,0,1,0,69,[],[]
1283871024073695232,SicCoP1,10,0,2,8,0,2610,[],[]
1340787334808104960,LivinginCalifo2,0,0,0,0,0,21,[],[]
1047979705318744064,JohnyDeplorable,0,0,0,0,0,166,[],[]
32418351,aeidinger,6,2,1,5,0,10318,[],[]
1154438374259908609,Always0468,0,0,0,0,0,84,[],[]
18662578,kepola58,0,0,0,0,0,3077,[],[]
1226291353,BluegypsyTom,1,0,0,1,0,264,[],[]
1177225792834756611,geraldb95284126,46,3,13,33,3,1352,[],[]
1220835242111651841,Ziggy23112,0,0,0,0,0,7,[],[]
846115344607514625,veryangrynana,0,0,0,0,0,10,[],[]
1325210499001196544,Rachell49669374,0,1,0,0,0,15,[],[]
756875774783725568,Ravneetsingh111,0,0,0,0,0,24,[],[]
1004082513441120256,MTMFM4,0,0,0,0,0,299,[],[]
1247205413340286978,JasnPouncey,0,0,0,0,0,12,[],[]
775843733820571649,ryan_plumer_,0,0,0,0,0,109,[],[]
1162521950289309699,rex_trump,4,0,1,3,0,600,[],[]
52657111,MadBeets,5,0,5,0,0,9646,[],[]
743283127,kevindgunn,3,2,0,3,0,1165,[],[]
1294415926188576768,RobertRichins5,0,0,0,0,0,1,[],[]
553871022,TheReaganWay,6,1,1,5,0,6942,[],[]
3469732107,tatiana_neroni,3,0,1,2,0,72,[],[]
937960547936595969,Mthoko_Mpofana,0,0,0,0,0,107,[],[]
754151456312176640,gregjoneskeepup,0,0,0,0,0,44,[],[]
493714995,johnpavlovitz,16157,2888,1717,14440,605,384796,[],[]
1203255352973766662,stanleygarlan10,57,2,31,26,3,1942,[],[]
16513335,votevets,1047,9,238,809,8,292411,[],[]
1333077988263550979,emilooouuu,0,0,0,0,0,635,[],[]
45555512,gjzaidan,0,0,0,0,0,359,[],[]
50087566,WildBill32571,0,0,0,0,0,22,[],[]
822897145497817088,NancyCoats57,101,25,15,86,8,8507,[],[]
2350957458,djbfromPark,0,0,0,0,0,3,[],[]
1973097782,JoelSGilbert,57,7,12,45,2,3370,[],[]
401090263,jonathanjewel,20,1,2,18,1,17212,[],[]
1427703655,GordonChales,1,0,0,1,0,95,[],[]
519850021,sport_hobos,0,0,0,0,0,12,[],[]
2629732851,onumazih,4,0,2,2,0,3453,[],[]
36731730,Catwomanlives,0,0,0,0,0,1767,[],[]
1281349101360156676,dannyki82808654,0,0,0,0,0,1,[],[]
441226499,SierraDragonsBr,0,0,0,0,0,39,[],[]
1272559122022629376,Storm4Congress,304,66,63,241,11,39886,[],[]
1051897158679584769,KennethLuzier,0,0,0,0,0,449,[],[]
201899932,Yutzy__,6,0,1,5,0,512,[],[]
121535590,JonGarbarino,13,1,2,11,0,6877,[],[]
1454299591,kidu2433,0,1,0,0,0,103,[],[]
527290048,gallop93,1,0,0,1,0,9475,[],[]
1081656731904688129,DonnaNeedham10,33,3,5,28,2,2547,[],[]
1323775906087919622,LisaStewart_5,1,0,1,0,0,146,[],[]
1239981396,im2secure,2,0,1,1,0,278,[],[]
137803557,fatboytke,0,0,0,0,0,817,[],[]
1013561770198347776,Shangri_La_38,3,0,2,1,0,453,[],[]
1088151346522537984,StephenPezza,1,0,0,1,0,2041,[],[]
1134855871794688000,ColinHull3,0,0,0,0,0,54,[],[]
1336758395181932545,ChristinaRethe6,0,0,0,0,0,1,[],[]
1193540962506510336,greekgoddess232,4,0,0,4,0,2068,[],[]
355466476,ooogaRTR,27,6,7,20,2,3262,[],[]
2317853540,shepcutter,0,0,0,0,0,15,[],[]
1328148857771921408,RevCJConner1,0,0,0,0,0,1,[],[]
322022153,patriotgirl5,12,2,0,12,0,1577,[],[]
628880091,FloridaManCory,2,0,1,1,0,444,[],[]
98152443,KarenLeeCC,0,1,0,0,1,106,[],[]
1265234861406793729,and_hypocrisy,0,0,0,0,0,37,[],[]
764529791168950272,DJT_Washington,0,0,0,0,0,11647,[],[]
3115961670,tschlep2,0,0,0,0,0,279,[],[]
955222984314249216,XtianKnight,0,1,0,0,0,47,[],[]
810991795857395712,candeebird,2,0,0,2,0,2092,[],[]
2849506260,EdavidlLevy,1,0,0,1,0,57,[],[]
805893330148139008,t_bone1764,0,1,0,0,0,76,[],[]
81995601,MAHENDRAGAUR,1,0,0,1,0,255,[],[]
1250121939227676673,the_herbig,14,1,0,14,0,2794,[],[]
25929383,sallydil,0,0,0,0,0,14,[],[]
3893250092,shine0ncrazyd,0,0,0,0,0,26,[],[]
801804439526998016,MAtrumplover,0,0,0,0,0,639,[],[]
1070046705343709193,SamMill55522037,0,0,0,0,0,4,[],[]
1048158058134822912,KarolGajdosK7,0,0,0,0,0,0,[],[]
132314931,MrPrecedent,2,0,0,2,0,311,[],[]
2551159062,jthackerson1,2,0,1,1,0,443,[],[]
714878407411150849,aldersonmary64,0,0,0,0,0,11,[],[]
533311687,Frostyflakes5,0,0,0,0,0,18,[],[]
1259488996075454465,Alex37643052,0,0,0,0,0,491,[],[]
703180532,LorettaMasaro,0,1,0,0,0,173,[],[]
2498536683,quietcrowd1995,1,2,0,1,0,421,[],[]
378720544,USPatriot336286,0,0,0,0,0,68,[],[]
170686159,ststee,0,0,0,0,0,321,[],[]
2283036890,ciphrelle,0,0,0,0,0,390,[],[]
3937263083,FrackHazReveal,4,0,2,2,0,4964,[],[]
739550592029184001,PuneetVuneet,8030,39,889,7141,20,29662,[],[]
1329920450336591881,Rkreb1,2,0,0,2,0,1677,[],[]
1336996280992722945,fromthesouth22,0,0,0,0,0,42,[],[]
1271099213414371330,MrsDoolittle3,0,0,0,0,0,11,[],[]
518986776,LowlyOpinion,2,1,0,2,0,110,[],[]
887813526341001216,55fordhotrod,0,0,0,0,0,2,[],[]
2941248573,meffen_james,0,0,0,0,0,26,[],[]
54347668,mawmy,0,0,0,0,0,2168,[],[]
730469674983555072,MissLoralei,0,0,0,0,1,1150,[],[]
1177000309266116610,SquireChet,25,1,8,17,0,5754,[],[]
808770361856786432,TruthWins22,71,6,15,56,2,6034,[],[]
1228547113,GManUSofA,0,0,0,0,0,303,[],[]
1012902130431258625,CatchGamma,2,2,0,2,0,85,[],[]
1229438754131238921,WendyTu17524235,0,0,0,0,0,0,[],[]
826206823694757888,yana_shapiro,0,0,0,0,0,2,[],[]
1735622912,BsoriceSorice,0,0,0,0,0,624,[],[]
1043203855247335424,MargauxR15,0,0,0,0,0,2001,[],[]
1293923311622197249,ptozer207,98,5,21,77,4,3365,[],[]
2653532131,lynniepoo78,1,0,0,1,0,357,[],[]
4904379597,kinross2016,0,1,0,0,0,685,[],[]
51408393,OliveStStudio,3,1,1,2,1,864,[],[]
16233278,NatesMama1128,3,0,1,2,0,2730,[],[]
29309026,bloodog,0,0,0,0,0,52,[],[]
4409220563,occhuckaranch,12,2,3,9,0,6312,[],[]
2616209796,scottadamsshow,7,0,1,6,0,14165,[],[]
133252126,malonespeaking,119,6,14,105,0,6252,[],[]
825858444578136064,JesRoger1,0,0,0,0,0,1044,[],[]
4820925174,CliffParks11,0,1,0,0,0,96,[],[]
923615713,tmentzer1962,1,0,1,0,0,1158,[],[]
1213795481060405248,quibbleframeup,2,0,1,1,0,42,[],[]
2277190305,1Patriot2020,6,4,2,4,1,4240,[],[]
1205355260467916805,JMDA_1,13,0,4,9,1,219,[],[]
1039327984300306432,straightplimp,1,0,0,1,0,504,[],[]
302292749,justplncate,0,0,0,0,0,739,[],[]
1298986250121015297,JoePhil52772833,8,1,2,6,0,3776,[],[]
801100959652970496,SpockResists,3677,92,791,2886,32,87851,[],[]
2815092115,wsieruk,0,0,0,0,0,32,[],[]
1327116445243719680,CardinalConserv,455,50,73,382,11,19931,[],[]
950758966115500032,segMIZZOU,1,0,0,1,0,99,[],[]
1090642362156699649,EdLyons19,0,0,0,0,0,16,[],[]
988684667426553856,Grettiwt2,0,0,0,0,0,276,[],[]
235417186,bellaluna113,1,0,0,1,0,86,[],[]
1345293504558362624,MarkJor89533010,0,0,0,0,0,0,[],[]
1416314034,YouAintBaut_It,1,0,0,1,0,445,[],[]
148123998,Swann_K,1,0,0,1,0,211,[],[]
394883311,milou1st,0,0,0,0,0,4273,[],[]
1237796620089131008,Kingchicken007,0,0,0,0,0,17,[],[]
4709569894,TTonyhenderson,0,0,0,0,0,1785,[],[]
56308041,rln22,6,2,4,2,0,1453,[],[]
422740651,AlexisC_777,1,0,0,1,0,20,[],[]
1321601773,christinal30_cc,0,0,0,0,0,3,[],[]
1342322640036442113,shakezulaDem,1,0,0,1,0,51,[],[]
761965519,MickGreenhough,3,0,1,2,0,8523,[],[]
749720759400960000,ZarrJeff,2,1,1,1,1,656,[],[]
1343211010644127746,pnoyes0,0,0,0,0,0,603,[],[]
61742678,trevorskies,0,0,0,0,0,632,[],[]
785124326588555266,kyrose87,7,0,1,6,0,6965,[],[]
63291596,xeauxeau,2,0,1,1,0,721,[],[]
2927367604,sheilayoung61,0,1,0,0,0,1029,[],[]
1343624687780302855,Newposter2,10,0,0,10,0,18264,[],[]
1315338635986849797,AuthentiCxts,0,1,0,0,1,34,[],[]
1018348406652264448,FirstInMyFam,0,0,0,0,0,17127,[],[]
232978630,BRG518,0,0,0,0,0,22,[],[]
2165235186,ranhoder,1,0,0,1,0,1183,[],[]
1893798024,_KingBlack90,0,0,0,0,0,1090,[],[]
326320315,kdlewis04,25,6,0,25,0,5331,[],[]
2236260139,NatalyBishop,0,0,0,0,0,7,[],[]
73738283,Ameristrong_FB,1,0,0,1,0,60,[],[]
2907847546,ClayHyink,1,0,0,1,0,10,[],[]
94862110,Natalie5Starr,3,1,0,3,0,2692,[],[]
1250065528309284871,pussy_insane,2,0,0,2,0,28,[],[]
17034524,Spasmo,0,0,0,0,0,1581,[],[]
2185617319,Dave_Naas,0,0,0,0,0,479,[],[]
1342199394062356481,TwatterSux8,1,0,1,0,0,308,[],[]
1333240881193816065,BillFre65650726,1,0,0,1,0,45,[],[]
25745099,WahlbergFanatic,0,0,0,0,0,566,[],[]
2892751263,stonecfox,0,1,0,0,0,470,[],[]
1345222917051854848,Ordinarystan1,0,0,0,0,0,0,[],[]
1146628678597697539,MikeEye1231,11,2,0,11,0,754,[],[]
1277769387278241799,SimonAmerica1,0,0,0,0,0,493,[],[]
1331125516984791042,JesusCh74101301,4,1,2,2,0,45,[],[]
1235643329959710721,apowell19851,0,1,0,0,0,122,[],[]
1085111648,letmarchonDC,2,2,1,1,0,656,[],[]
811909988952047616,Vanbombie,0,4,0,0,0,4,[],[]
763407082112610304,MrLouRod,0,1,0,0,0,11,[],[]
165811205,freudmayweather,2,0,0,2,0,518,[],[]
1169989954371543041,MayBerr14391505,0,0,0,0,0,338,[],[]
1291854080604807169,Jwil42384860,0,0,0,0,0,0,[],[]
335034817,dump61,3,0,0,3,0,293,[],[]
3039131661,barneystoneage,9,1,3,6,0,913,[],[]
414073191,RodgerDodger4,11,4,3,8,0,6469,[],[]
1021036868283052032,wkn4alivin,0,0,0,0,0,159,[],[]
2748101909,Boortzfan66,0,0,0,0,0,1160,[],[]
2358686786,dmartin6235,0,0,0,0,0,14,[],[]
1344401812623929351,KINGARTHUR3378,0,0,0,0,1,18,[],[]
2723634428,Samamiller4,0,0,0,0,0,11,[],[]
707366631316578304,dr_reasoner,0,0,0,0,0,1682,[],[]
1075345500155441152,HowardHuston5,0,1,0,0,0,1,[],[]
825536081302990849,jbeser10,1,1,0,1,0,251,[],[]
193303589,TheKuderMoose,0,0,0,0,0,615,[],[]
930499460,novachocolat,0,0,0,0,0,210,[],[]
3249326565,davidson3246,0,0,0,0,0,99,[],[]
808006297828421632,AlDesatron,0,0,0,0,0,3,[],[]
1236023655408246786,Richmichals1098,0,0,0,0,0,21,[],[]
1306061387723137027,EnemyLinesRadio,0,0,0,0,0,74,[],[]
632387904,jwegs78,4,2,0,4,0,537,[],[]
885581376,JoyceBruns,4,1,1,3,0,3339,[],[]
827356610347560961,ultramanflyer60,11,2,5,6,0,2840,[],[]
372135917,RochelleCabirac,20,3,2,18,3,320,[],[]
1033793299683991553,Raf_eColii,0,0,0,0,0,54,[],[]
1329806455910715392,SNewLondonShow,0,1,0,0,0,14,[],[]
48932604,Scott0020,30,0,4,26,0,2521,[],[]
3315526335,timfish_2000,0,1,0,0,0,430,[],[]
35398075,clint4liberty,2,0,0,2,0,159,[],[]
1271128031730569216,TeflonTuron,0,0,0,0,0,471,[],[]
1018297903784386561,globalbounce8,0,0,0,0,0,1727,[],[]
3329874167,Allisongk9700,2,0,0,2,0,13852,[],[]
1087548651965218816,Willems1T,0,0,0,0,0,83,[],[]
1167890967250251776,TheFrugalBanker,1,1,0,1,0,3129,[],[]
45489606,eelect,0,0,0,0,0,485,[],[]
16941994,mjhillenbrand,0,0,0,0,0,1420,[],[]
1313639282972790784,BigWrench6,0,0,0,0,0,5,[],[]
1597192136,the_real_shaneg,8,2,2,6,1,1283,[],[]
1344486423496445953,joesmit33273489,0,0,0,0,0,3,[],[]
1569701208,statisticsphd,1,0,0,1,0,2521,[],[]
186943407,beingfrancake,1,1,0,1,0,408,[],[]
938039765886210050,Stickballruss,8,2,0,8,0,444,[],[]
1289321986989096960,daleundetected,2,0,0,2,0,1733,[],[]
1025094945684836352,Grumpy_ESQ,0,0,0,0,0,3,[],[]
887992214,mrsgailgaham,0,0,0,0,0,7,[],[]
1336320612977975300,ms08243,0,0,0,0,0,1,[],[]
94106705,GrammaLucy,2,0,0,2,0,4,[],[]
260739410,thebencheah,13,1,2,11,0,1869,[],[]
1311468893798567940,Dana37870456,0,0,0,0,0,376,[],[]
2553218186,missiongirl4,8,2,0,8,0,392,[],[]
1322884360694018052,MightyGHog,2,0,1,1,0,259,[],[]
20897281,ashually,1,0,0,1,0,213,[],[]
443852641,stopbeingaderp,11,0,4,7,0,5622,[],[]
1273405243771027456,fastback2045,0,0,0,0,0,14,[],[]
1315941468993855490,witchfinda,0,0,0,0,0,17,[],[]
25110386,Redroadmaster,1,0,0,1,0,2095,[],[]
79650587,Jerkyman62,0,0,0,0,0,5,[],[]
441262761,americanwombat,5,2,1,4,0,5946,[],[]
936433471710314497,NorthernLightzg,5,0,1,4,0,467,[],[]
1316513873105752065,MChentnik,0,0,0,0,0,0,[],[]
1196858410135719936,FelViktor,3,0,0,3,0,1634,[],[]
1312050263298056195,hindman_deb,1,0,0,1,0,244,[],[]
813311743,NumbersMuncher,1015,36,149,866,18,68142,[],[]
1329161620493377537,CraigFM1789,0,0,0,0,0,5478,[],[]
753484425795661824,loribarnett71,0,0,0,0,0,974,[],[]
44385628,gregkellyusa,8760,2083,959,7801,361,438866,[],[]
911390695281315840,RonOlson007,0,0,0,0,0,50,[],[]
923656786841886726,redhot0072,0,0,0,0,0,8,[],[]
1155727404532293632,AnonSmythe,0,0,0,0,0,0,[],[]
1266913871052238848,MartinNZ1969,7,0,1,6,1,7664,[],[]
1318359979016003585,saviin_jen,10,2,0,10,0,161,[],[]
206362857,dennishchristen,12,0,3,9,0,36889,[],[]
990580767272022016,will_larimer,0,0,0,0,0,27,[],[]
3022955034,seandawson_,1,0,0,1,0,309,[],[]
1638112423,mtnavarre,0,0,0,0,0,32,[],[]
193743738,KnightGambit,5,1,1,4,1,4543,[],[]
88661109,LMerritt1,0,0,0,0,0,5744,[],[]
987088394240122887,KingMakerFT,105,4,32,73,9,6868,[],[]
28127007,SScarborough,0,0,0,0,0,365,[],[]
922132923326849025,leegi1089,0,0,0,0,0,2555,[],[]
71999799,Stoller99,0,0,0,0,0,66,[],[]
1739379852,Karencrowee,2,0,0,2,0,122,[],[]
15698032,Knoxer,1,1,0,1,0,2444,[],[]
2209782696,RonWils51572583,0,0,0,0,0,3158,[],[]
817758682607996928,Longhrn_Nation,2,0,0,2,0,2275,[],[]
24073436,OhBlondie66,0,0,0,0,0,864,[],[]
1311820647664820224,BTolotta,0,0,0,0,0,2,[],[]
1059325188368527360,gokunaruto3000,8,0,0,8,0,1207,[],[]
423908992,CisqoSuawce,11,1,1,10,0,430,[],[]
771791833,cannoneerfour,1,0,0,1,0,7519,[],[]
60300412,michaelrzerby,0,0,0,0,0,195,[],[]
753675739615100930,MorMor65596702,1,0,1,0,0,6786,[],[]
1339264299684999168,Trumpismypres2,0,0,0,0,0,0,[],[]
902805025,94969902Momma,0,0,0,0,0,632,[],[]
790758565447368704,MoschbergerD,1,0,0,1,0,18,[],[]
4741770732,robertbtracy,116,24,33,83,15,5428,[],[]
25034688,YourDailyIncome,0,0,0,0,0,611,[],[]
2694885096,FrancisRoyCA,1,0,0,1,0,451,[],[]
913871728765530112,BreakdownWithWB,0,0,0,0,0,64,[],[]
2870197210,White_Eagle49,0,0,0,0,0,80,[],[]
3016407990,JoannJtamez,0,0,0,0,1,13,[],[]
1268792197693886464,trixieh20,0,0,0,0,0,71,[],[]
1344477607270764544,oscar70106718,13,0,4,9,0,1,[],[]
1220108644869713921,JonathanLesnie1,15,1,8,7,3,162,[],[]
264923477,jessinwis,0,1,0,0,0,908,[],[]
1948144706,ChrisVc4000,14,0,6,8,0,3,[],[]
182554941,eastsideeddie,0,0,0,0,0,981,[],[]
1952901463,abbycool30,1,0,0,1,0,1957,[],[]
1341886313763631106,PjZipe,4,0,2,2,0,8,[],[]
1328026613519302656,Susie43475707,0,0,0,0,0,0,[],[]
921896843960897536,millionmagamen,0,0,0,0,0,44,[],[]
413382873,GasMaskBunny,0,0,0,0,0,112,[],[]
66372566,1stcitizen,0,0,0,0,0,2330,[],[]
820329734827483136,leow_aw,0,0,0,0,0,46,[],[]
1327978404394774529,Jimmyboi85,0,0,0,0,0,62,[],[]
47534393,chevymo,10,0,2,8,0,7272,[],[]
1094449606392344576,TruegritG,17,2,2,15,0,18581,[],[]
898620354,sirtatters,1,0,0,1,0,10231,[],[]
4266261,benkunz,5,1,0,5,0,8453,[],[]
51798648,eloisehoney,0,0,0,0,0,64,[],[]
46034763,RedStateApostle,0,0,0,0,0,10,[],[]
724774298997641217,acestwo59,6,0,2,4,0,17285,[],[]
1174337776831143939,SimonSo75650539,0,0,0,0,0,1,[],[]
28390896,MolieveDat21,2,0,0,2,0,999,[],[]
776242142,DarrenJaws,1,0,0,1,0,1017,[],[]
1285262525215518720,CoryFlowers16,0,0,0,0,0,3,[],[]
597388583,JosephOyeleye,0,0,0,0,0,59,[],[]
898357964083531777,myersdanielx,1,0,0,1,0,36,[],[]
1269716992933523456,Molly74125796,0,0,0,0,0,3,[],[]
61662979,LumLotus,51,14,4,47,0,2596,[],[]
3797192722,destinjbl,0,1,0,0,0,83,[],[]
1325193429941424130,R2D2_2020,3,1,0,3,1,127,[],[]
241156624,BlueDoggin45,0,0,0,0,0,6234,[],[]
1964748174,VMCKimmey,139,5,23,116,4,2149,[],[]
4140674352,FallowsDirk,1,0,0,1,0,104,[],[]
1091717345091964928,notadmblnd,3,1,0,3,0,7424,[],[]
795463422460788736,steve88keys,51,0,9,42,0,53,[],[]
1190300554171473920,ConspiracyBull1,351,25,54,297,7,29825,[],[]
881287076502753281,Fair_and_Biased,3,1,1,2,0,1723,[],[]
254301862,kellwoohoo,3,0,1,2,0,6115,[],[]
1334637686091616261,57parallel,6,0,2,4,0,219,[],[]
3381177351,NickWDevito,0,0,0,0,0,402,[],[]
803695157480550401,GeorgeShaeffer1,0,1,0,0,0,19,[],[]
1162859099266007040,oh_my_ers,2,0,0,2,0,130,[],[]
21024215,tttravis,0,0,0,0,0,10,[],[]
1297302099844194305,Gary14717739,0,0,0,0,0,1,[],[]
33459146,bellsdarling,0,0,0,0,0,106,[],[]
47107118,CyrusShares,16,3,6,10,2,4031,[],[]
1278276135785132032,TedCrilly666,22,1,6,16,1,899,[],[]
1077630052421042177,travels_we,0,0,0,0,0,1,[],[]
1889051149,radelster,0,0,0,0,0,47,[],[]
1271706899264634885,k_shepjerd,0,0,0,0,0,4,[],[]
45652349,kruano447,1,1,0,1,0,907,[],[]
1116667990060277760,cheensters,1,0,0,1,0,444,[],[]
1612106185,rxquxl,3,0,0,3,0,1036,[],[]
1264308967578185729,Magoo579088521,0,0,0,0,0,9,[],[]
1334885363207159809,Rick73999311,0,0,0,0,0,23,[],[]
76992264,jerkotyuk,0,0,0,0,0,318,[],[]
882495356868493312,PatriotCause1,7,1,1,6,0,12215,[],[]
868474066201653248,StephenLHall,5,1,0,5,0,703,[],[]
18462462,lynnchu,0,0,0,0,0,798,[],[]
1315875015963754496,Manchu889,0,0,0,0,0,358,[],[]
34189045,swervinerv82,4,1,1,3,0,2993,[],[]
1341828314063921153,e_bike_mike,1,0,1,0,0,3,[],[]
314895207,aFriendlyNative,1,0,0,1,0,29,[],[]
36796163,MyMessiahJesus,0,0,0,0,0,266,[],[]
2954658724,judy_bishara,0,0,0,0,0,1,[],[]
1266369913871974401,MaraSloan11,0,0,0,0,0,0,[],[]
1326976540148547584,1776molonlabe1,0,0,0,0,0,189,[],[]
1300582515674152961,pantsmonki,2,0,0,2,0,48,[],[]
22444668,lynmac44,0,1,0,0,0,9,[],[]
1286340237724200961,JuanPeaG1,0,0,0,0,0,836,[],[]
1276715734949904384,AmericanPragma2,0,0,0,0,0,446,[],[]
21097864,lastingfaces,0,0,0,0,0,15,[],[]
937639507,Katiea27A,0,0,0,0,0,1808,[],[]
268063667,thelsns,0,0,0,0,0,210,[],[]
913550041,CowboyKate49,0,0,0,0,0,247,[],[]
225227931,LarryTaunton,81,6,18,63,2,21070,[],[]
1344531511278592000,ZeonTrotsky,0,2,0,0,0,791,[],[]
1192213032698613767,cherokeefromda1,0,0,0,0,0,12,[],[]
1312944394765557761,delurker13,0,0,0,0,0,1934,[],[]
772634771751047168,__GuidoFawkes,0,0,0,0,0,176,[],[]
1115766901,kbeckham61,1,0,0,1,0,104,[],[]
4363421652,WendyReedTweet,0,0,0,0,0,1390,[],[]
104354164,JohnTDori,4,0,1,3,0,572,[],[]
247020496,creepmxther,1,1,0,1,0,1216,[],[]
18448119,redwhiskeypete,277,13,72,205,7,21491,[],[]
753244834572500994,JackScout22,1,0,0,1,0,6,[],[]
1310639140669714434,OleGelo5,2,0,0,2,0,13851,[],[]
369823293,StarNealy1,0,0,0,0,0,0,[],[]
1130242193514520576,RichardClip,25,2,5,20,1,4903,[],[]
1243294103581982737,TheRealBruceLe2,0,0,0,0,0,1028,[],[]
484272263,TDTQ,0,0,0,0,0,1905,[],[]
1341765305098522625,Butch09589493,0,0,0,0,0,2,[],[]
1315501306958606336,ReimTopher,9,1,1,8,0,9583,[],[]
20485834,ideapalooza,2,0,0,2,0,1076,[],[]
4515203596,condelles_w,0,0,0,0,0,599,[],[]
329084015,lulu_king,0,0,0,0,0,1,[],[]
500990663,clashcitym,0,0,0,0,0,128,[],[]
216910715,happymartie1,0,0,0,0,0,1946,[],[]
341061002,Gwwalk14,0,0,0,0,0,302,[],[]
904142211138367488,obinagaoda,0,1,0,0,0,188,[],[]
61960666,bobcra302,0,1,0,0,0,60,[],[]
85495832,annthecabby,2,0,0,2,0,19272,[],[]
2713119937,sthmarco,1,0,0,1,0,72,[],[]
1335681995377156096,intercessor714,0,0,0,0,0,76,[],[]
32679104,Dichotomy2u,1,0,0,1,0,187,[],[]
532550602,uca79,0,0,0,0,0,2764,[],[]
1139988382422065152,Micklawton2,0,0,0,0,0,9,[],[]
755230715739049988,carlos_bonanza,0,0,0,0,0,112,[],[]
91138808,ryry_05,0,0,0,0,0,347,[],[]
1315364898461843458,JerryGarvin8,0,0,0,0,0,1,[],[]
4690516249,6wRich,0,0,0,0,0,190,[],[]
1147573127788027904,kevester3,1,0,0,1,0,401,[],[]
890151278,lostinthevote,0,0,0,0,0,540,[],[]
2998658360,RuelGolden,13,0,1,12,0,515,[],[]
509720618,THLADYRICHR10,1,0,0,1,0,100,[],[]
2432538624,gduba2014,0,0,0,0,0,8,[],[]
447090672,CastilloJulie,0,1,0,0,0,2651,[],[]
410428466,DrScottYoung,14,1,1,13,0,7189,[],[]
762014236893732864,Shivajihimself,4,1,0,4,0,8521,[],[]
16471241,MirPeace,1,0,0,1,0,1600,[],[]
2942489492,Roniboyhero,0,0,0,0,0,634,[],[]
91623824,jorge_guajardo,24,0,4,20,0,56303,[],[]
1697158711,ALEXANDER7___,0,0,0,0,0,3494,[],[]
2293756165,seagod22,1,1,0,1,0,1280,[],[]
380135677,erinmariepls,0,1,0,0,0,76,[],[]
984375832230719488,tap_gary,2,0,0,2,1,741,[],[]
898918784,PatceeS,0,0,0,0,0,28,[],[]
796328309210501120,DonaldWithrow1,0,0,0,0,0,233,[],[]
3115791215,nwillg,0,0,0,0,0,99,[],[]
1278745456667955200,BeanoChico,1,0,0,1,0,1014,[],[]
4272218535,nahtalieeee,0,0,0,0,0,181,[],[]
1266138493933293569,realaudratoop,6,0,3,3,1,653,[],[]
1344650572197208066,QuantumHealing6,0,0,0,0,0,55,[],[]
457820209,railboy63,6,0,4,2,0,7249,[],[]
1309596695475433474,LouSassel4L,0,0,0,0,0,3,[],[]
526525411,NastySketch,0,0,0,0,0,7,[],[]
1045768605680447488,GeorgeBeland1,0,0,0,0,0,0,[],[]
1100153767708819457,SandySmithNC,568,63,85,483,12,25272,[],[]
104343945,JohnRobtMoody,0,0,0,0,0,985,[],[]
1146085420360507394,sach_vichaar,1,0,0,1,0,951,[],[]
1319434080312791045,Li84164937,0,0,0,0,0,5,[],[]
3004382651,michael407931,1,0,0,1,0,2479,[],[]
86165075,Mandys610,7,1,0,7,0,867,[],[]
47512609,APH48,31,2,11,20,2,5110,[],[]
949323877158617089,FreetheButerfli,21,0,4,17,2,1956,[],[]
1249442521274408961,fakeMikeFallis,0,0,0,0,0,10,[],[]
2572849701,DizzyDaisy909,0,0,0,0,0,205,[],[]
1284705858488692736,Rational571,0,1,0,0,0,6293,[],[]
121766554,rsamplecom,3,0,0,3,0,980,[],[]
727520736844226561,actionashley13,1,0,0,1,0,1263,[],[]
1239688501114941440,JaniceFarley11,0,0,0,0,0,52,[],[]
1317925609327218688,SandyRusso,0,0,0,0,0,1,[],[]
346275650,simoneandbebe,0,0,0,0,0,390,[],[]
262164257,bstott2002,0,0,0,0,0,554,[],[]
1174340029277200385,TolucaPhd,6,0,2,4,0,5440,[],[]
285862495,TagSherman,7,2,0,7,0,586,[],[]
2221004006,VaDivorcee,0,0,0,0,0,28,[],[]
33993178,fermayo,1,0,0,1,0,175,[],[]
1066323118543831041,Monkeymom17,1,0,1,0,0,14,[],[]
500327421,crimsonscull,0,0,0,0,0,43,[],[]
887772914,GiGiEspericueta,4,0,1,3,1,770,[],[]
1327016486695702528,MckennaSkip,0,0,0,0,0,1,[],[]
402831122,BengalBeanie,0,0,0,0,0,152,[],[]
727686411827085312,ohreallywth,0,2,0,0,0,50,[],[]
1253562477322932226,PatriotofUSA_,0,0,0,0,0,54,[],[]
2538200653,chastityallen74,21,2,3,18,0,9083,[],[]
21695423,whuddumsayin,2,0,0,2,0,729,[],[]
1223482940,southhillskenny,3,0,0,3,0,143,[],[]
431399266,wise_michael,0,0,0,0,0,85,[],[]
853371595,Scooter4002,71,5,7,64,0,58126,[],[]
1233444221744533505,Concerned_Dems,1,0,1,0,0,634,[],[]
1336819589670428674,21cent_patriot,0,0,0,0,1,4,[],[]
1299359222912647170,italian_snead,0,0,0,0,0,5,[],[]
30953,extraface,1,0,0,1,0,1628,[],[]
845628793,CryptoCoinFree,0,0,0,0,0,6843,[],[]
1224916243083407361,PowerLevel1776,4,0,0,4,0,625,[],[]
1064980030164484096,latner_saundra,0,0,0,0,0,205,[],[]
114303340,MatthewNDuval,0,0,0,0,0,177,[],[]
570816898,DclareDiane,3,1,1,2,1,8272,[],[]
1306358622146957312,habsenfuka,1,0,0,1,0,450,[],[]
880298635090677760,Tanya_RBLee,3,0,0,3,0,326,[],[]
57080481,budparker,0,0,0,0,0,469,[],[]
707131003,DeannaDeanna061,13,0,4,9,2,2822,[],[]
759511635870552064,BodemerGuy,1,0,0,1,0,5115,[],[]
729842846,robdbob1,0,0,0,0,0,9703,[],[]
862429950,cdparrott,2,0,1,1,0,951,[],[]
1080112488903888896,RFRyo_,0,0,0,0,0,334,[],[]
880474475829055489,americanshomer,9,0,5,4,0,15664,[],[]
3043280612,luiz_cerveira,0,1,0,0,0,1451,[],[]
1292067906092593154,aussiePatriotG2,0,0,0,0,1,339,[],[]
1363137961,BookwormAngela,0,0,0,0,0,81,[],[]
1293776999400398849,Kid71375156,13,0,3,10,0,1424,[],[]
155775712,mliz77,12,2,2,10,0,8528,[],[]
1108781190910304256,karen_elaine444,0,0,0,0,0,66,[],[]
1306759470274486273,Brad05339280,2,0,2,0,1,5,[],[]
1054765588852170752,Richardkimble45,2,1,1,1,0,3437,[],[]
853678860,acedoda,1,0,0,1,1,3887,[],[]
24001196,DianneInIndiana,19,0,2,17,0,9220,[],[]
1345940180,PaulSorrentino3,201,7,40,161,1,9456,[],[]
60681940,rylcash,0,0,0,0,0,10060,[],[]
707033483869204480,Richard83423970,0,0,0,0,0,70,[],[]
703366485297729539,RINOwithHorns,2,1,0,2,0,1093,[],[]
1031628988685410305,ML08646141,0,1,0,0,0,1893,[],[]
2446627560,brank4625,0,0,0,0,0,1,[],[]
1681864346,CornettLaura,0,0,0,0,0,5,[],[]
77339359,Darrinbillingsl,62,8,23,39,2,7852,[],[]
1114789409763680257,bo_skool,0,0,0,0,2,14,[],[]
1959304292,communisensu,0,0,0,0,0,417,[],[]
1519393718,AMGrace63,8,0,1,7,0,12868,[],[]
1314347597402906624,binkscat1,17,0,5,12,0,2720,[],[]
157972164,chaser1066,0,0,0,0,0,1816,[],[]
1334002551096832000,Jerry96708449,0,1,0,0,0,0,[],[]
1613819856,absmom1,1,0,0,1,0,904,[],[]
709379884146003969,Shadybug60,0,0,0,0,0,423,[],[]
2737894317,Nokk21,0,0,0,0,0,8,[],[]
826937071780626433,cooksonwma,0,0,0,0,0,1884,[],[]
765960190713888769,JoanneH48055804,2,0,1,1,0,239,[],[]
863183161789906944,JoelSirner,0,1,0,0,0,48,[],[]
24597909,DavidHolford,1,0,0,1,0,135,[],[]
81156174,JIME2u,0,0,0,0,0,70,[],[]
18267466,ladyliberty01,0,2,0,0,0,2728,[],[]
2945773214,IAmNotLiberal,0,0,0,0,0,1930,[],[]
41272915,Soproncopo007,54,10,17,37,3,18186,[],[]
1334467620893036545,soflmiami39,0,0,0,0,0,293,[],[]
1188815232145219584,RogueTeam1,42,0,9,33,0,1167,[],[]
1002020638209576961,BethHeindel,5,0,1,4,0,274,[],[]
1120405909765857280,FukrFukn,0,0,0,0,0,4,[],[]
1342750930547003392,AntitheticTrump,0,0,0,0,0,16,[],[]
3246198000,lucinda_herbert,3,0,0,3,0,538,[],[]
2212814203,BigD_GCS,0,0,0,0,0,68,[],[]
1240448155151478784,CothronWilliam,0,0,0,0,0,10,[],[]
1291571430,Shawn23G,0,0,0,0,0,303,[],[]
823283563206307840,SRCallieD,0,0,0,0,0,3,[],[]
749383228369219589,go_garyo,6,0,4,2,1,507,[],[]
195271137,larryelder,1215,42,192,1023,11,962395,[],[]
100099434,treeofdeborah,0,0,0,0,0,1,[],[]
422173752,RogerNorris1,4,0,1,3,0,8220,[],[]
2502333227,OG_Dr_Zoidberg,0,0,0,0,0,14,[],[]
1325990529411153920,toje13648190,0,0,0,0,0,2,[],[]
959289032155979776,OMGQAnon,1,0,0,1,0,3978,[],[]
703487050016759808,crosshimoffthen,0,0,0,0,0,419,[],[]
1277639741765230593,WMayhand,0,0,0,0,0,5,[],[]
345016408,Jackle5225,2,0,1,1,0,84,[],[]
1281266878908977157,CommonSense2076,1,0,0,1,0,867,[],[]
15787840,sophie832,0,0,0,0,0,89,[],[]
1323644623496118277,BESTPRESEVER_45,1,1,0,1,0,40,[],[]
299134234,terrythorn1,0,0,0,0,0,25,[],[]
2214175112,billt457,0,0,0,0,0,1,[],[]
1169462952757551107,dowop_robinson,12,1,2,10,0,4162,[],[]
47511179,DogwoodMama,4,0,0,4,0,560,[],[]
2357530375,stmfitter1,0,0,0,0,0,218,[],[]
1334456750754459649,InTheWo66702371,2,0,0,2,0,32,[],[]
1151726591090647040,DavidMo48520745,0,0,0,0,0,125,[],[]
1340669938961240064,SherriBoggess,2,0,0,2,0,26,[],[]
17533234,llloyd123,0,0,0,0,0,1156,[],[]
3889486125,DolioJ,18,1,4,14,0,11467,[],[]
921105283908296704,nightwarrior603,1,0,0,1,0,6732,[],[]
67601005,arlyndae,0,0,0,0,0,310,[],[]
904093470855380992,RichardLally13,0,0,0,0,0,5,[],[]
952417124852617218,IGierzak,5,1,0,5,0,3073,[],[]
1077633989610037248,RickHumphreys3,0,1,0,0,0,5,[],[]
1339075163829186568,trumpIost,0,0,0,0,0,77,[],[]
2324852065,McNamaraCpa,0,0,0,0,0,53,[],[]
305157377,Qigongshaman,5,0,3,2,0,30,[],[]
771730778539438080,jessejrvasquez1,2,0,0,2,0,3761,[],[]
278303790,Phil_GA,2,16,1,1,1,251,[],[]
4889714145,willisten5,1,0,1,0,0,1957,[],[]
1193571028070469644,Michele94190189,0,0,0,0,0,1,[],[]
459591628,BigLeagueTJ,0,0,0,0,0,324,[],[]
1306086362802651136,SaveOurSharks5,1,0,0,1,1,28,[],[]
1330669291528622082,hippygirl2020,2,0,0,2,0,3138,[],[]
31756043,Buffalo4thewin1,1,1,0,1,0,33,[],[]
1267808180719046657,red95hut,26,4,4,22,2,3505,[],[]
579023908,johnjordan1969,0,0,0,0,0,3619,[],[]
3932334796,emgalura,0,0,0,0,0,0,[],[]
135631210,Drp985,2,1,0,2,0,1753,[],[]
309738646,rjthinks,1,0,0,1,0,500,[],[]
2811494022,wkstott,1,3,0,1,0,2964,[],[]
58646912,larriemoss,0,1,0,0,0,881,[],[]
1297207110875242496,Luv2ride6,1,0,0,1,0,469,[],[]
1191406287541723136,ChadSpecialist,6,1,1,5,0,350,[],[]
796614175439077376,JohnRDay3,0,0,0,0,0,220,[],[]
1328127465982668800,Heather60347908,0,0,0,0,0,0,[],[]
825770165333872641,lona_barrett,1,0,0,1,0,1287,[],[]
1235526231447220226,RLsloanes,0,1,0,0,0,305,[],[]
4226879500,ChJLuc91,0,0,0,0,0,3287,[],[]
2546606893,les_barney,0,1,0,0,0,7,[],[]
134025866,StanfordAlan,2,0,1,1,0,701,[],[]
2826874189,realmikenemesi,2,0,0,2,0,309,[],[]
1026638179388911617,elisa_the_mess,1,0,0,1,0,733,[],[]
498078382,ladycscorpion,0,0,0,0,0,1115,[],[]
2254943684,bworkman2002,0,0,0,0,0,129,[],[]
57100100,dougalmac54,0,0,0,0,0,60,[],[]
1852802612,C__DiLorenzo,81,6,11,70,0,2629,[],[]
1341481686232653824,OshaSenator,1,0,0,1,0,8,[],[]
705504735609135104,A_FACT4U,1,0,1,0,1,126,[],[]
897905180162785285,Patriot_1952,89,3,22,67,1,5111,[],[]
935232119059578880,TopShelfAnarchy,0,0,0,0,0,128,[],[]
71893885,ValVenisEnt,25,0,1,24,0,30854,[],[]
3300226157,daisyllight,1,0,0,1,0,1399,[],[]
984456036399570944,KirkPendergras,5,0,2,3,1,70,[],[]
973519619230121984,mythicboot24601,0,0,0,0,0,34,[],[]
1206075203731673088,SunnySydeRamsay,3,0,0,3,0,128,[],[]
1268716601744011264,Whitney95455695,0,0,0,0,0,5,[],[]
321937906,DefunctUser,0,0,0,0,0,188,[],[]
1959451742,bombaywallah56,1,1,1,0,0,1700,[],[]
30193159,AlanDeFunk,0,0,0,0,0,60,[],[]
1086702165178093569,MarkLothian1,2,0,1,1,0,637,[],[]
1184456891952455681,NHLIEAA1,0,0,0,0,0,27,[],[]
24316742,ClaySikes,0,0,0,0,0,830,[],[]
1225191886941556736,newt60440770,1,0,0,1,0,48,[],[]
168013772,rojo2k,3,1,0,3,0,2678,[],[]
1256217070838087680,sheliacharlton4,0,0,0,0,0,198,[],[]
1164568795777814528,PMcIndependent,1,0,0,1,0,308,[],[]
2923520850,EdwardSaffaJnr,1,1,0,1,0,83,[],[]
1296479840078450688,BrianFMartin2,0,0,0,0,0,2,[],[]
1324893395190390784,IsabelleNikoli8,0,0,0,0,1,162,[],[]
16267083,Screeminmeeme,2,0,0,2,0,2866,[],[]
229049650,willowpete,0,0,0,0,0,26,[],[]
56212771,verndewd,0,0,0,0,0,1354,[],[]
937657432716791808,trumparasite,7,0,0,7,0,773,[],[]
2981982491,teacharacter,0,1,0,0,0,37,[],[]
705441650076684288,thedoggeneral1,37,2,11,26,1,12550,[],[]
126805810,ZachZDE,0,0,0,0,0,225,[],[]
1021807403225047040,Barndg,0,0,0,0,0,2,[],[]
311691936,time2behappy101,0,0,0,0,0,279,[],[]
3301790667,Currency365,90,3,10,80,0,5049,[],[]
371009090,MattGeorgeMoore,2,0,0,2,0,579,[],[]
710486225031856128,patricia_wages,2,0,0,2,0,1292,[],[]
540470880,pat1214567,0,0,0,0,0,153,[],[]
1282317368765677568,homeagainmom,0,0,0,0,0,0,[],[]
2275563031,Akredblood,0,0,0,0,0,16,[],[]
76113619,Arubakt,0,0,0,0,0,15,[],[]
824705293514932226,flints1963,8,0,0,8,1,4339,[],[]
1039150569661902848,realTheo5,1,0,0,1,0,92,[],[]
342850161,McRambaud,0,0,0,0,0,1377,[],[]
1902331501,OSOK1961,0,0,0,0,0,682,[],[]
16098592,drwh0,0,0,0,0,0,573,[],[]
858411081919848449,JohnPen83554397,4,1,0,4,0,1793,[],[]
1332512523061391360,biden_antifa,0,0,0,0,0,59,[],[]
1344511328921276416,Dean04470201,0,0,0,0,0,1,[],[]
1264751589300076545,PaulHal83159238,1,1,0,1,0,844,[],[]
15211869,jamie_love,2,3,0,2,0,10455,[],[]
72580029,rightinillinois,9,4,2,7,1,2713,[],[]
1136444209312018432,KMuia3,0,0,0,0,0,47,[],[]
249032182,Pvt_Frank,0,0,0,0,0,23,[],[]
30047513,Chuckforevver,0,0,0,0,0,742,[],[]
2275337142,DrSamGirgis,58,6,6,52,1,20720,[],[]
955293669602439168,TheLoop12741459,6,0,0,6,0,2161,[],[]
1308590305772531713,iwasthinkingg,0,0,0,0,0,0,[],[]
30767799,LiLSenatorMitch,0,0,0,0,0,223,[],[]
1268400898641817601,RebekahKilling1,1,0,0,1,0,38,[],[]
1034759355537735680,EdgyNathan,1,0,0,1,0,601,[],[]
25725899,RocketMom5300,0,0,0,0,0,451,[],[]
1344502424413773824,dougie4960,0,0,0,0,0,8,[],[]
1133881834322968576,HZardoz,0,0,0,0,0,846,[],[]
151104800,GIGISFLYING,2,0,1,1,0,3263,[],[]
1217574117521707014,JackNethercot,0,0,0,0,0,4,[],[]
191156581,daviddavidsocal,15,0,3,12,0,13191,[],[]
1267131387825577990,billthecloser,0,1,0,0,0,18,[],[]
928277885151887360,Whosaclown,3,0,0,3,0,2989,[],[]
1183226870529187840,UsaLovethe,5,1,0,5,0,1285,[],[]
999500697832972288,BrandonHuxel,0,0,0,0,0,62,[],[]
354919513,galts1teaparty,3,2,2,1,0,608,[],[]
934276566695079936,scorpio8675309,10,1,0,10,1,1356,[],[]
1081990029487017985,jodybrody22,1,0,0,1,0,349,[],[]
1326990993443450880,DALEBEL28525629,0,0,0,0,0,3,[],[]
16688724,BrianNormoyle,11,3,0,11,0,3691,[],[]
44542844,CaliBlondeLady,5,0,1,4,0,16268,[],[]
200755338,Paul_Stewart22,0,0,0,0,0,148,[],[]
4282269619,KevinFehr2,1,0,0,1,0,72,[],[]
1232462769968025601,JamesWoodman327,1,0,0,1,0,3,[],[]
607531241,stewthedeluxe,0,0,0,0,0,277,[],[]
2775942496,ThankYouRight,4,2,2,2,0,759,[],[]
1321176382374858752,__theaquacave,1,1,0,1,0,530,[],[]
1883761776,whitecorona,0,0,0,0,0,230,[],[]
1229474556332560384,uno_bandit,0,2,0,0,0,143,[],[]
1144554074957918208,Maryclouse9,0,0,0,0,0,5,[],[]
119504200,DennisCarothers,0,0,0,0,0,2760,[],[]
492410227,griffey1965,0,1,0,0,0,91,[],[]
1212907416884400130,BrooksB10393092,0,0,0,0,0,10,[],[]
22548025,MoonInVeritas,0,0,0,0,0,1479,[],[]
1656021,mr4d65,0,0,0,0,0,201,[],[]
628906718,cecilyhandy,0,0,0,0,0,27,[],[]
1273027274925846529,WarrenT94182890,0,0,0,0,0,51,[],[]
15832775,SincerelyAmanda,0,0,0,0,0,2179,[],[]
1281608587891138560,StacyV05394821,0,0,0,0,0,652,[],[]
355794287,MrMcLarty,0,0,0,0,0,446,[],[]
1301856420489502720,ZeusLite1,0,0,0,0,0,14,[],[]
2869618630,ExtremeArturo,2,0,0,2,0,10772,[],[]
982654931663491073,gma4471,0,0,0,0,0,52,[],[]
14801786,dlcama,0,0,0,0,0,2983,[],[]
2852597261,julie_kelly2,1226,54,247,979,39,210861,[],[]
177092966,SNRay61,0,0,0,0,0,4327,[],[]
168321389,vegix,236,12,64,172,5,56788,[],[]
918183866766065664,Oldgloryfighter,4,0,1,3,1,8475,[],[]
825054615481618432,wemophil,14,0,4,10,0,24669,[],[]
1013813874095808515,DudesJoe,0,0,0,0,1,38,[],[]
121823132,stalltherain,1,0,0,1,0,134,[],[]
217952607,Leeds13thChild,0,0,0,0,0,2,[],[]
276808748,mom22sr,7,0,2,5,0,1145,[],[]
1726612291,brad_oland,11,4,1,10,0,2576,[],[]
1340287476154445825,EdwardMac20,6,0,4,2,0,243,[],[]
299710611,tickles23,2,0,0,2,0,558,[],[]
1133254168217509889,incognito_nunya,9,0,1,8,0,5129,[],[]
16408207,TeeBern,2,1,1,1,0,11282,[],[]
51668744,theCutemartian1,4,1,0,4,0,138,[],[]
19831323,mikeboudreau,0,0,0,0,0,1503,[],[]
1201180799896129536,bbryce_m,0,0,0,0,0,19,[],[]
1074860668405407745,LindaNi48331863,2,0,1,1,0,10,[],[]
3025220800,otsfpineapples,0,0,0,0,0,142,[],[]
2992854313,oxley0419,0,0,0,0,0,74,[],[]
805906194216861696,thieriotski,2,2,0,2,0,2092,[],[]
891246133,KedronBardwell,5,2,0,5,0,3424,[],[]
1288378628254961665,ToniWil62284149,0,0,0,0,0,40,[],[]
74467054,JaredMitchellB,0,0,0,0,0,55,[],[]
37291403,Astroalcher,0,1,0,0,0,238,[],[]
978265628426432512,patriottakes,18919,688,1192,17727,70,443401,[],[]
1928294772,HumbleAndSaved,1,0,0,1,1,157,[],[]
1281245692711837696,diakrisis1776,30,1,3,27,2,1508,[],[]
266137209,tercarlson,1,0,0,1,0,303,[],[]
1307205071558631425,vincent38087093,1,0,0,1,0,54,[],[]
1080150256040505345,ActivatedTo,1,1,0,1,0,4215,[],[]
2351721400,Xpletiv3Deleted,3,0,0,3,0,331,[],[]
288419716,Kayp2011,0,0,0,0,0,171,[],[]
232648801,bquicker,0,0,0,0,0,363,[],[]
14432483,thedeziner,2,0,1,1,0,7198,[],[]
1143296723638337536,Marston4ca42,136,6,22,114,0,49602,[],[]
424385885,DavidClarkGA,446,26,100,346,19,6314,[],[]
2784978781,KyserClark,1,0,0,1,0,1376,[],[]
1479249355,TammyEDH,1,0,0,1,0,458,[],[]
100028303,gattor612,0,0,0,0,0,6,[],[]
714941047,jayy1093,4,1,0,4,0,132,[],[]
822072365194637314,KeFuller,1,0,0,1,0,278,[],[]
2494312387,VickieCouch22,6,0,2,4,0,1150,[],[]
457228624,Jim_Eich,0,0,0,0,0,1,[],[]
993719394,suit24601,5,0,0,5,0,2032,[],[]
137356738,JeffRoseTV,42,4,10,32,1,6125,[],[]
1184176846478417920,Vincent83551915,0,0,0,0,0,250,[],[]
3013697869,Shimpinainteasy,0,0,0,0,0,176,[],[]
3092185387,SchleifJennifer,0,0,0,0,0,289,[],[]
116810805,pugsandco,9,1,0,9,0,1239,[],[]
4906902279,Missileofficer,0,0,0,0,0,1,[],[]
547545196,SalesFitzgerald,0,0,0,0,0,23,[],[]
366173698,RonnyReich,0,0,0,0,0,224,[],[]
937723542975561728,mbs86058591_mbs,1,0,1,0,0,78,[],[]
35850768,iDenae,0,0,0,0,0,67,[],[]
1199359675784933376,b_treyes,0,0,0,0,0,0,[],[]
3105172496,Lionhearted0723,1,0,0,1,0,164,[],[]
2727390144,msjeannerogers,22,2,5,17,0,11113,[],[]
1262131783887396872,FrankTA69719593,4,0,1,3,0,4781,[],[]
1176061982539206656,shalenawilliam4,0,0,0,0,0,52,[],[]
276608220,MadMaxCrypto08,1,0,0,1,0,1344,[],[]
362006082,bestpi,0,0,0,0,0,316,[],[]
2429027815,ScarlettDear1,9,1,3,6,0,12078,[],[]
1231769536371871744,missourigirl16,1,0,0,1,0,547,[],[]
3295253583,jasonwalters85,143,16,6,137,1,9157,[],[]
271654961,AustinH_08,1,1,0,1,0,390,[],[]
78466206,FlPatriot41,2,0,0,2,0,156,[],[]
1084210857184116736,Ninety7Bravo,8,2,0,8,0,938,[],[]
2955964961,HonestCyn,0,0,0,0,0,212,[],[]
725110219,FREDERICK_SPARS,0,0,0,0,0,5106,[],[]
2285833400,ezt714,0,0,0,0,0,14,[],[]
402419752,thefirstjana,2,1,0,2,0,1359,[],[]
138449212,SandySAtHome,0,0,0,0,0,15,[],[]
1324100102512934917,patriots_ohio,5,1,1,4,0,451,[],[]
1216096697450778624,buybcbud,0,0,0,0,0,44,[],[]
11744382,sanguish,1,0,0,1,0,4656,[],[]
958764073868578821,Eeelpout,0,0,0,0,0,29,[],[]
35475237,nurselori65,0,0,0,0,0,783,[],[]
743951674641784835,abnertod81,4,0,2,2,0,4641,[],[]
1335278201170497537,Howardt11173754,0,0,0,0,0,2,[],[]
18089606,KurtSchlichter,2397,170,209,2188,33,412528,[],[]
899049246,supersingalong,0,0,0,0,0,227,[],[]
1330030617212358657,MagnusBenson1,0,0,0,0,0,1172,[],[]
1249750560770842626,Charles41695724,0,0,0,0,0,3,[],[]
877602348423458816,robertw26241,1,0,0,1,0,805,[],[]
873911832045645824,deckape_1,5,1,3,2,0,20408,[],[]
1140725860334493700,TLDavis37696301,4,0,1,3,0,1452,[],[]
2333887729,artdirobertsArt,0,0,0,0,0,6,[],[]
1185010297226092544,Kenneth88191233,6,0,1,5,0,3224,[],[]
19926675,RepKevinBrady,48,99,11,37,5,57268,[],[]
1522266182,Cak9147,0,0,0,0,0,30,[],[]
21857150,Hoogineer,0,0,0,0,0,22,[],[]
1242253591,space__garbage,1,0,0,1,0,113,[],[]
99556016,toddsplanet,20,3,1,19,0,7797,[],[]
847651706242441216,Schul4School,0,0,0,0,0,34,[],[]
1316348352041234433,MikeNew01991263,0,0,0,0,0,594,[],[]
1041161353,terabug29,1,0,0,1,1,30,[],[]
61659880,kellementary,1,1,0,1,0,1036,[],[]
2182295380,liesielou9,0,0,0,0,0,51,[],[]
1236401107779362818,nystate_alex,6,0,1,5,0,240,[],[]
564947756,Dark_Red_Hair,3,2,1,2,1,24311,[],[]
2429571337,bwright037,0,0,0,0,0,135,[],[]
18401612,delbertyoung,0,0,0,0,0,3246,[],[]
1337883807156989959,SavvySalamande1,0,0,0,0,0,0,[],[]
2610587552,Banky1974,2,2,0,2,0,242,[],[]
446627393,wraphouse01,5,1,0,5,0,129,[],[]
1295707146554765314,Michael_Z1012,7,1,3,4,1,17511,[],[]
925833813959364608,GuardianJunebug,0,0,0,0,0,18,[],[]
14833352,NameBrandDealz,0,0,0,0,0,160,[],[]
2704948956,mrs_svt_mace,1,1,0,1,0,177,[],[]
267776990,SOUNDtheRETWEET,1,0,0,1,0,1724,[],[]
4445498741,PatriciaAHenso1,0,0,0,0,0,7261,[],[]
136320636,RealPhxGwen,0,0,0,0,0,4,[],[]
1276317562385641472,wannabePrez46,0,0,0,0,0,1,[],[]
954190826506211329,think4_urself,1,0,0,1,0,279,[],[]
1013556252431925248,caliJerm,0,0,0,0,0,351,[],[]
280639031,MusicNtheBrain,0,0,0,0,0,1031,[],[]
1298778440275984388,ozarkmomma2A,0,0,0,0,0,224,[],[]
537457604,mikey_trolls,0,1,0,0,0,283,[],[]
876572910483374081,KarateBob29,0,0,0,0,0,85,[],[]
876449009728180224,Robertchef77,6,2,3,3,1,2407,[],[]
821134182982287361,RobertEimiller,2,0,1,1,0,2972,[],[]
600613713,gfitz35,0,0,0,0,0,21,[],[]
1406387671,briangobosox,8,0,1,7,0,1864,[],[]
408903897,nomallorywrites,1,0,0,1,0,1634,[],[]
22264026,wsrphoto,0,0,0,0,0,57,[],[]
73246234,shipper12,0,0,0,0,0,12,[],[]
16329185,frankjames,0,0,0,0,0,1393,[],[]
26529462,Shanvhere,2,0,1,1,0,43,[],[]
1218558850711900161,EugeneWindchy,0,0,0,0,0,60,[],[]
3174108999,pastoramberd,0,0,0,0,0,95,[],[]
1197711173556170752,abhorrentethics,1,0,0,1,0,264,[],[]
954060732521504768,AfriWorldNews,12,3,1,11,2,790,[],[]
3499821328,yohiobaseball,309,17,70,239,7,6318,[],[]
1071915231444692993,HourrHappy,0,1,0,0,0,8,[],[]
2217914231,diehl455,0,0,0,0,0,6,[],[]
1339167432745889793,Libtroll1776,1,1,0,1,0,18,[],[]
1325545995376209920,FedUp80107238,3,1,1,2,0,19,[],[]
845158560,DoRtChristians,15,2,5,10,1,19738,[],[]
1909821,JoeMoreno,1,1,0,1,0,10809,[],[]
18523518,SentinelX,4,3,2,2,0,131,[],[]
851425868912230400,Charles10149166,0,0,0,0,0,540,[],[]
794051304,BillHabeeb,3,1,0,3,0,40,[],[]
1298034866055819271,redstategent,0,0,0,0,0,810,[],[]
376932886,daniel_fainberg,0,0,0,0,0,333,[],[]
1094625713544667138,TruePatriot_USA,0,1,0,0,0,37,[],[]
1317184835245453312,RacerX23011493,1,0,0,1,0,7370,[],[]
1567813328,boyer04,0,0,0,0,0,30,[],[]
1271162030393896968,Logically_JC,2139,63,415,1724,42,111663,[],[]
159494523,tickelsurfancy,0,0,0,0,0,3163,[],[]
732372881687085056,CattVanDo,7,1,2,5,2,122,[],[]
1342325191549083649,gabrams66,1,0,0,1,0,17,[],[]
16475168,RosettaDrone,5,2,1,4,0,6474,[],[]
3128695279,GaryAmerica7,1,0,0,1,0,7,[],[]
2215890902,LouClinicEscort,6,1,1,5,0,6226,[],[]
1293321006212292608,TullimonstrumC,18,0,6,12,2,6898,[],[]
22254932,jazzsaw,0,0,0,0,0,29,[],[]
1266032005164052483,GovScrew,2,0,1,1,0,310,[],[]
1246094572020805633,southerndude00,0,0,0,0,0,47,[],[]
1309316929346179072,Scarlett2020925,0,0,0,0,0,1058,[],[]
1053830573058338816,Anonymo84903207,0,0,0,0,0,0,[],[]
100343376,TweetMeRight66,0,0,0,0,0,1987,[],[]
407506945,longbeard180,0,1,0,0,0,274,[],[]
1163815870793158656,UnionDude4,4,1,0,4,0,4197,[],[]
219904738,bwalshaxp256,2,0,1,1,0,91,[],[]
851510561695313921,TheRealDogCIC,1,0,0,1,0,501,[],[]
1307701327007416322,Paulett14584593,11,3,3,8,0,7584,[],[]
299853153,LizB_Russell,0,0,0,0,0,473,[],[]
1162734159665565698,No_Blinders,0,0,0,0,0,1167,[],[]
36196568,KellDA,12,4,2,10,0,30000,[],[]
521023521,joethebluesman,0,0,0,0,0,726,[],[]
537422485,TalkinGenealogy,4,0,2,2,0,771,[],[]
771063415741743104,butch92,0,0,0,0,0,74,[],[]
2927088595,ralanbarker,1,0,0,1,0,2438,[],[]
19911013,offbeatagent,2,0,0,2,0,6656,[],[]
724599002,JoyOverbeck1,1,1,0,1,0,3420,[],[]
1141009702354075650,LibertyAnders,200,23,7,193,2,50492,[],[]
385233229,MikaelBenBaruch,0,1,0,0,0,1871,[],[]
110007667,dwd9491,4,1,2,2,0,214,[],[]
65022817,catherineberlin,0,0,0,0,0,151,[],[]
911943686400995329,DosEquis52,0,0,0,0,0,23,[],[]
275177558,MrsNormanToYou,3,1,2,1,1,345,[],[]
524006776,jthatter,0,0,0,0,0,776,[],[]
2322523468,CarolAngelo65,0,0,0,0,0,102,[],[]
4691985930,radical4truth,0,0,0,0,0,49,[],[]
22416413,UKnowIamRight,0,0,0,0,0,1694,[],[]
1159540638897061889,SammyJeter1,0,0,0,0,0,0,[],[]
1153693570680926210,LoveItOrLeave12,0,0,0,0,0,3289,[],[]
1059480867016503299,BradSchaeppi,1,1,0,1,0,408,[],[]
786159238401908737,ambuehl_toni,2,0,0,2,2,108,[],[]
4611881123,davidmc1592,2,1,0,2,0,435,[],[]
161513849,JVegas01,0,0,0,0,0,233,[],[]
25596553,RyanJSuto,0,3,0,0,0,1914,[],[]
1344414264468107270,freedom_tribune,1,0,0,1,0,53,[],[]
23968266,AndrewGatto,1,0,0,1,0,405,[],[]
3090939294,rlcook2219,2,0,1,1,0,3386,[],[]
3234152323,joy_djkr71,0,0,0,0,0,1277,[],[]
1274436649380917251,the_right_girl4,151,58,14,137,11,5596,[],[]
1271060750602252290,JohnMax12665996,50,2,13,37,7,2564,[],[]
850633633,DPJ1369,5,1,0,5,0,37534,[],[]
788086385769115649,csu_daniel,0,0,0,0,0,573,[],[]
831876974234759168,ezzi1954,0,0,0,0,0,15,[],[]
1275496504405504000,MelgRoberts1,2,0,1,1,0,0,[],[]
461702925,bgrauone,1,0,0,1,0,115,[],[]
79460073,cspanSnark,1,0,0,1,0,433,[],[]
14076275,kekkepikkuni,0,0,0,0,0,4344,[],[]
197439550,BerniePiazza,0,0,0,0,1,84,[],[]
32426278,pgadan59,0,0,0,0,0,609,[],[]
938411371691151365,DARobinson4Him,0,0,0,0,0,0,[],[]
3493563087,Monaheart1229,101,17,20,81,6,20450,[],[]
40748632,MikeKassep,7,3,1,6,0,109,[],[]
14886998,Dchinni,2,0,0,2,0,3529,[],[]
787375926917070848,denise_tierney3,0,0,0,0,0,9,[],[]
2239382563,DeWayne236,8,0,2,6,1,6965,[],[]
66779283,jgorman6,0,0,0,0,0,225,[],[]
839038155579760640,fweespch,0,0,0,0,0,6,[],[]
106276217,jeanp422,0,0,0,0,0,82,[],[]
633466950,lildebnurse,1,0,0,1,0,578,[],[]
977682231216017408,strike4ourearth,1,0,0,1,0,2167,[],[]
375722297,JtDirtyBirdy,1,0,0,1,0,617,[],[]
339759734,farmwifeee,0,0,0,0,0,294,[],[]
25669608,Dreamweasel,193,11,27,166,2,23323,[],[]
22261182,ywwd,0,0,0,0,0,131,[],[]
3403127757,concetta8631,9,1,3,6,0,5898,[],[]
1249785654180843520,QuestonEvrythng,0,1,0,0,0,270,[],[]
581974519,SteelGimlet,2,0,1,1,0,6694,[],[]
1339431934406103043,Cormbreab2,0,0,0,0,0,188,[],[]
1332070912687034372,boflower,0,1,0,0,0,6,[],[]
363893602,paulgalloshow,1,0,0,1,0,9547,[],[]
976692405129768960,yinepu2022,2,0,0,2,0,90,[],[]
1272002948839735300,Outlaw257776078,4,0,2,2,0,3062,[],[]
723867230052581376,blakkmajik3000,0,0,0,0,0,12,[],[]
1262911892902817794,JNewfarious,0,0,0,0,0,30,[],[]
760385332575608832,MilitarisCath,63,2,23,40,4,8785,[],[]
963182422048190467,Pasquale527,0,0,0,0,0,64,[],[]
67685197,JohnMacD1,1,0,0,1,0,444,[],[]
1288907456752517120,sabroxkent,0,0,0,0,0,64,[],[]
3942398472,maoli_kingdom,1,0,0,1,0,24,[],[]
1168925446316019712,wilbourcraddock,1,2,0,1,0,172,[],[]
380196069,robbothekid,3,11,0,3,1,851,[],[]
808877936816189440,xekrami,0,0,0,0,0,2620,[],[]
993641287,dazdix,2,0,0,2,0,1771,[],[]
2837385675,1Tim6_1,0,0,0,0,0,2546,[],[]
1330523898786443264,nbd57kb82scralv,0,0,0,0,0,34,[],[]
525843137,I_AM_brosiedon,1,0,0,1,0,292,[],[]
329823736,JohnRenodin,0,1,0,0,0,2,[],[]
1305858945404276736,JohnWar33029289,0,0,0,0,0,4,[],[]
1277304791295762433,lindp12,0,0,0,0,0,3228,[],[]
18896440,princellasmith,0,1,0,0,0,4109,[],[]
1040351729903194117,WillWat14922206,2,0,2,0,0,2758,[],[]
1260313591821094912,ConcernedScien5,0,0,0,0,0,412,[],[]
26344731,Paulahochman,2,0,0,2,0,3617,[],[]
154357876,chessie12222,0,0,0,0,0,2509,[],[]
133769431,MisterSalesman,32,7,6,26,1,376111,[],[]
1262811311962021893,TIM_S_M,0,0,0,0,0,114,[],[]
819580862647980032,33David3,0,0,0,0,0,2,[],[]
1343940583635742724,tonyp84174176,0,0,0,0,0,0,[],[]
2435999924,joeafonso2,0,1,0,0,0,112,[],[]
3198426720,patmabraham,3,0,0,3,0,315,[],[]
3132952471,libertybluefre1,0,0,0,0,0,196,[],[]
17840754,miamilawyer,1,0,0,1,0,147,[],[]
1296423233269518336,AmVoterAlliance,1631,31,328,1303,43,3068,[],[]
437973594,Thomas_John93,1,0,0,1,0,625,[],[]
289927326,markdaventry,2,0,0,2,0,1012,[],[]
931895636517052417,NIGE8SPQR,1,0,1,0,1,779,[],[]
757815036161110016,BLONDEBOMB68,0,0,0,0,0,133,[],[]
2607124097,FOE_01,4,0,2,2,0,3753,[],[]
108721209,paulvmarks,1,0,0,1,0,759,[],[]
338081831,WendyCR1872,0,0,0,0,0,156,[],[]
1087810770979749890,AgentGoldstar,1,0,1,0,0,309,[],[]
136462474,truthbeforepc,8,0,3,5,0,1680,[],[]
1283759671065616385,jDavidSlaugh1,0,0,0,0,0,5,[],[]
25652189,kelskye,2,1,0,2,0,86,[],[]
1733391854,tjbabel,2,0,0,2,0,963,[],[]
1165762201250074624,AbrahamSegxy,1,0,0,1,0,57,[],[]
2322055595,influencejon,0,0,0,0,0,52,[],[]
1139857873113157632,TonyTeacher1988,0,0,0,0,0,215,[],[]
427924454,jakkoerner,1,1,0,1,0,61297,[],[]
998073851945795584,VancityRacing,0,0,0,0,0,1032,[],[]
1510500986,McCoyCher,0,0,0,0,0,593,[],[]
728320763988574212,renayhowey_fit,2,0,1,1,0,104,[],[]
1268399550927998976,LindaTh27168341,34,2,5,29,1,847,[],[]
1276849570421637127,Superboep2,1,0,0,1,0,930,[],[]
1314765631867084800,Scout20202,0,0,0,0,0,1052,[],[]
26707201,GoldenLady18k,0,0,0,0,0,279,[],[]
67212271,MissAusPatriot,1,0,0,1,0,1463,[],[]
1341128964648161283,LeeGrand18,3,2,1,2,0,442,[],[]
1270135738609385472,danielgleebles,0,0,0,0,0,52,[],[]
980727758,M_McMullenAggie,5,0,2,3,0,15615,[],[]
1342989247314329600,SDrainer17,0,0,0,0,0,3,[],[]
99636622,4JMAN,2,0,0,2,0,1483,[],[]
24078313,renatte68,0,1,0,0,0,1327,[],[]
118469188,AdamBrassfield,12,0,3,9,0,2033,[],[]
65947287,rpkelly55,3,0,0,3,0,44,[],[]
618588991,Johnnietaco,3,0,1,2,0,485,[],[]
1330281824334077953,Sai_N2UiC,1,0,0,1,0,470,[],[]
578525346,WeSurvivedObama,87,13,34,53,5,18410,[],[]
352224598,davemyopinion,4,1,1,3,0,3535,[],[]
20341061,Eternalifeisbtr,0,0,0,0,0,47,[],[]
1027171994,cscat19,0,0,0,0,0,18,[],[]
1326171209617317888,TerlinguaV,6,3,3,3,2,276,[],[]
1121439273432043522,DerangedTT,11,3,3,8,1,4087,[],[]
366903225,pkopelke,0,0,0,0,0,2050,[],[]
1139749037148495873,MisterHeart10,4,0,0,4,0,1257,[],[]
1341604107996553219,mil_vet17,0,0,0,0,0,18627,[],[]
1330884081173848065,Whodare42277584,0,1,0,0,0,30,[],[]
1019968322408996865,IntelDankWeb,9,2,1,8,0,1475,[],[]
1336595601958469635,HumanMandela,0,0,0,0,0,257,[],[]
16556523,tedfrank,21,1,0,21,0,18278,[],[]
782707098635436032,JeffMartin8372,3,0,1,2,0,5557,[],[]
1108203999847743488,FormerlyOk,0,0,0,0,0,405,[],[]
946779951730003968,leftyphilosophy,4,1,0,4,0,539,[],[]
158116771,MadPatriot65,1,0,0,1,0,3304,[],[]
4780832983,MrRichardPaul,7,0,3,4,1,893,[],[]
461732002,MAshHi1313,1,0,0,1,0,194,[],[]
730629716,DoreenHDickson,0,0,0,0,0,1708,[],[]
1091194303,BigAirbat,0,0,0,0,1,445,[],[]
1171392272786583553,corevaluehk,0,1,0,0,0,2,[],[]
561776862,swb427,2,0,0,2,0,71,[],[]
922435392,GunAkay47nar,0,0,0,0,0,90,[],[]
104730935,Seneca_88,0,1,0,0,0,448,[],[]
936355167745736706,jay_is_awes0me,0,0,0,0,0,259,[],[]
1343387226001047553,unorthodoxideas,0,0,0,0,0,124,[],[]
308062165,LukaszukAB,402,12,42,360,1,29694,[],[]
3308971249,Juliesm11254774,3,1,1,2,0,275,[],[]
549546684,lynnepelletierc,2,0,0,2,0,6912,[],[]
789549446942056448,wickedjester83,1,0,0,1,0,245,[],[]
