User ID,User Name,Node_weight,Reply Count,Retweet count,Like Count,Quote Count,Followers Count,FOllowerID,Follower name
747209683480514561,airmax3328,0,0,0,0,0,54,[],[]
867438710,sixpackjax,10,1,2,8,0,1275,[],[]
1180527460342996992,PeeWee91197678,0,4,0,0,0,5018,[],[]
512075729,daledurbin,0,0,0,0,0,274,[],[]
72717148,thatmoosethere,2,0,1,1,0,59,[],[]
1250594352,JebbYoung,0,1,0,0,0,103,[],[]
2922382356,georgebarnes311,9,3,1,8,0,2351,[],[]
1084342056766427136,MaryBittel,12,0,0,12,0,12982,[],[]
22699733,surfgranma,0,1,0,0,0,294,[],[]
1037847942307213312,FireTornado11,0,0,0,0,0,17,[],[]
967268286000906240,OscarTheWilder,1,0,0,1,0,278,[],[]
17629983,TruthJoyLove,13,0,2,11,0,7001,[],[]
829520625249120257,criter_dee,11,5,0,11,0,3167,[],[]
17134275,njfrese,7,0,2,5,0,2359,[],[]
901130763302785026,libertytrader17,7,13,2,5,3,342,[],[]
2865271230,nonyabiz_liz,0,1,0,0,0,22,[],[]
1245907135873142785,Scottttttieboy,4,0,0,4,0,1440,[],[]
33243860,shipwatchbarbie,2,0,0,2,0,115,[],[]
1023026582670127104,screen_tan,1,0,0,1,0,153,[],[]
344748850,RosettaSH,0,0,0,0,0,9,[],[]
411621494,judymorris3,11,8,0,11,2,4395,[],[]
245978005,carole_shirley,0,0,0,0,0,1,[],[]
87603897,DHallNole,0,0,0,0,0,2452,[],[]
554725710,lisacohanaronow,2,1,0,2,0,4179,[],[]
1949789970,bblock29,2836,749,326,2510,121,107553,[],[]
2321665076,ChateauErin,2,0,0,2,0,221,[],[]
1122592467646386176,ArchSta33796501,1,0,0,1,0,105,[],[]
28674575,TAZyaqui,5,0,2,3,0,111,[],[]
131373718,Perednia,6,0,2,4,0,5771,[],[]
74938121,welcomehier,14,2,5,9,1,2069,[],[]
263697010,Technocorp,5,2,1,4,0,429,[],[]
1272853595709419521,JimJimbo1986,0,0,0,0,0,4,[],[]
714699415,SaintJimothy,1,1,0,1,0,41,[],[]
2393944766,Ge_no1,2,0,1,1,0,158,[],[]
191778197,Muzamana_Victor,0,0,0,0,0,684,[],[]
421395580,RebeccaBowling,21,1,6,15,0,10011,[],[]
335576999,alaskarebel,6,2,2,4,0,13458,[],[]
1337500359175102465,ChuckHogan10,9,0,0,9,0,577,[],[]
1409100236,LeighHolm,0,0,0,0,0,26,[],[]
1031909388,golfnutallways,0,0,0,0,0,16,[],[]
881613314815602688,KeithMugser70,0,0,0,0,0,87,[],[]
9116332,harriekd,3,1,0,3,1,2990,[],[]
288283415,daxtonbrown,12,0,1,11,1,26721,[],[]
2509492162,Projected_PE,0,0,0,0,0,738,[],[]
49234006,glenobrien,1,1,0,1,0,630,[],[]
108995250,mdbohrer,0,0,0,0,0,112,[],[]
1169348688776323072,GoldenfireMJ57,1,0,0,1,0,2815,[],[]
16371333,HeDwells,0,0,0,0,0,1059,[],[]
1341791641510825985,OustThune,17,2,7,10,0,1574,[],[]
343039951,Radio_zaza,0,0,0,0,0,19,[],[]
4435283293,Gidgett378,0,0,0,0,0,1813,[],[]
885886567838908416,jt_westfield,0,0,0,0,0,4,[],[]
281658270,yourrant,0,0,0,0,0,158,[],[]
1338528662480674824,keep_tx,0,0,0,0,0,2,[],[]
845635178756259841,solomon9143,16,3,1,15,1,3309,[],[]
1167660632,DLTM55,0,0,0,0,0,16,[],[]
18057294,twfarlan,5,1,1,4,0,774,[],[]
74716713,mpc1980,0,0,0,0,0,1269,[],[]
24026214,RavenLaR,0,0,0,0,0,666,[],[]
1238273302675800064,NStevenson613,0,1,0,0,1,20,[],[]
1325798179,UsaPresent,0,0,0,0,0,17,[],[]
1214990522147901440,LindaJo14782683,0,0,0,0,0,0,[],[]
506082238,jbphotoAR,6,0,1,5,0,844,[],[]
1234636264101552129,RightRedRtn,16,1,5,11,2,2478,[],[]
219204344,TreadKarma,0,0,0,0,0,25,[],[]
705479333599645696,DrD9800,0,0,0,0,0,11,[],[]
898226852958937088,idahogal1006,1,3,0,1,0,899,[],[]
745480599322791936,kennedy197699,0,0,0,0,0,3,[],[]
1260333231255232515,PagingTasha,0,0,0,0,0,25,[],[]
989945852,CoreyD_23,0,0,0,0,0,452,[],[]
930261937,b1blazin,0,0,0,0,0,1299,[],[]
1124780128792346624,NPendent,687,17,76,611,4,8965,[],[]
227814309,MManiotis,2,0,1,1,0,101,[],[]
1346249632679161856,orangemanrad0,0,1,0,0,1,76,[],[]
130254817,russellwiley,0,0,0,0,0,865,[],[]
2761319012,Phillies2k8,0,0,0,0,0,7,[],[]
1088042539549114368,GRAHAMG27894453,2,0,0,2,0,114,[],[]
251641567,RKenneson,0,0,0,0,0,2414,[],[]
1270380698,Team_Ponle_OX,1,1,0,1,0,149,[],[]
34643610,EricBoehlert,4044,119,592,3452,41,232569,[],[]
534380406,MmePB,0,0,0,0,0,1001,[],[]
2447038212,Aethonaia,8,3,2,6,1,3302,[],[]
34659442,haldavis3,0,2,0,0,0,395,[],[]
204444440,DawnsMission,2814,316,488,2326,102,108084,[],[]
1249594897113513985,keith3048,119,33,9,110,3,6689,[],[]
4284893477,ByfsBrenda,0,1,0,0,0,68,[],[]
24471951,carolmswain,2086,79,426,1660,69,82857,[],[]
17520068,RickFreedland,45,2,12,33,1,2674,[],[]
46775436,BettyBowers,831,19,106,725,3,285867,[],[]
157037473,Chris_Levesque_,12,0,1,11,0,3206,[],[]
29384303,DaisyBelleLace,0,1,0,0,0,2027,[],[]
49035017,mijoda3,0,0,0,0,0,2889,[],[]
372798512,BErickson_BIO,1,0,1,0,0,1611,[],[]
801480576209453056,iianhxwee,1,1,1,0,0,47,[],[]
522778902,FranceAgainstDT,0,0,0,0,0,30,[],[]
1276151044658118658,Dino5614,0,0,0,0,0,23,[],[]
126134277,chuckghunter,69,2,13,56,6,1132,[],[]
27435791,zowie46,2,0,1,1,0,198,[],[]
125649950,TannousOTL,316,10,64,252,8,689,[],[]
1241118317043204096,FoolsBelieve,36,5,2,34,0,9542,[],[]
1088184572758581248,ReinekeRoxanne,0,0,0,0,0,624,[],[]
1174445643559067648,Manga4Congress,18,1,4,14,1,4399,[],[]
48110509,MrWildstyle,25,3,2,23,0,6862,[],[]
1022329417396301824,HPlaydat,2,0,0,2,0,3905,[],[]
887510287401852928,JunicusPublius,0,0,0,0,0,140,[],[]
17456691,brobert545,141,17,42,99,9,18755,[],[]
901211568398008321,J_David_Clarke,0,0,0,0,0,1183,[],[]
46705814,Lynnenallo,5,0,0,5,0,5883,[],[]
48162522,BastianTiger,1,0,0,1,0,1516,[],[]
1164796233405235200,yellowmangood,0,0,0,0,0,1094,[],[]
4064335367,Professing_Prof,17,1,3,14,0,7051,[],[]
1222293377145688064,passtheballimo2,0,0,0,0,0,1383,[],[]
1270534769097363457,JFidiam,0,0,0,0,0,1,[],[]
2229208368,torinspiration,1,0,0,1,0,271,[],[]
996585149344108545,zismo64,3,0,2,1,0,6879,[],[]
1332381264050008065,mary_less,0,0,0,0,0,18,[],[]
19078155,freaktet,0,0,0,0,0,511,[],[]
48106612,mangekimambi,18,3,0,18,0,95403,[],[]
28435993,derev,0,0,0,0,0,31,[],[]
748667203692670976,Khailward,0,0,0,0,0,4,[],[]
1136701327579521025,ELewarne,2,0,0,2,0,1100,[],[]
1344063256063860736,Theresa31369421,0,2,0,0,0,34,[],[]
23341160,ConsiderThis1,4,2,1,3,0,13036,[],[]
1098996262391685121,JacobBr76233303,0,0,0,0,0,12,[],[]
409081240,tjstrophies,1,0,0,1,0,70,[],[]
166624872,LeeGrins,3,0,1,2,0,1253,[],[]
898922697261973504,Jack013161,4,0,1,3,0,1082,[],[]
17176378,only2degrees,3,0,1,2,0,5885,[],[]
96631851,sacraficial,0,0,0,0,0,3821,[],[]
1338575113575337985,OBNO4,1,0,0,1,0,17,[],[]
2715701197,ben_benbennett,2,1,1,1,0,1675,[],[]
901280816159916032,robbyusea,4,0,0,4,0,6321,[],[]
4382621477,RiDavlo,0,0,0,0,0,838,[],[]
19408986,Trump2020_Again,42,5,10,32,1,30369,[],[]
119899010,jeff_romack,1,0,0,1,0,670,[],[]
1478241456,babytoddsb34,1,1,0,1,0,276,[],[]
234502375,smugdingus,4,0,0,4,0,3606,[],[]
61008839,LABeachGal1,720,71,151,569,21,28335,[],[]
59531539,DonnaGHBryant,0,0,0,0,0,153,[],[]
6418032,Jack_Beitz,0,1,0,0,0,717,[],[]
402427957,TeddyOccupy,0,0,0,0,0,216,[],[]
540238571,bellobass,0,0,0,0,0,707,[],[]
1320875316861116416,DonnyD59696297,0,0,0,0,0,32,[],[]
445198322,Look_its_Rhonda,11,1,0,11,0,3121,[],[]
43686402,iclarity2,0,1,0,0,0,612,[],[]
75717372,KrisPigna,0,0,0,0,0,115,[],[]
896420168242532353,JennXMommie,2,0,1,1,0,14,[],[]
600557530,Brendan_Atkins,1,0,0,1,0,162,[],[]
1246820602935197696,Voice4Florida,2,0,0,2,0,376,[],[]
418571483,everstalwart,1,0,0,1,0,134,[],[]
329111873,Walli59,1,0,0,1,0,2194,[],[]
4554866359,junkitupyo,0,0,0,0,0,287,[],[]
89333079,tammy_42141,3,0,0,3,0,578,[],[]
46194602,Shamrock_Dan,0,0,0,0,0,692,[],[]
1335631300166823939,Michael03605267,0,0,0,0,0,1,[],[]
799063658638753794,racer2825,0,0,0,0,0,10,[],[]
15471575,donkaye,1,0,0,1,0,1094,[],[]
260650395,djfallu,0,0,0,0,0,141,[],[]
14260758,mingomonk,0,0,0,0,0,553,[],[]
269948707,AmzingAmbssador,0,0,0,0,0,484,[],[]
34850231,TonyinNY,0,0,0,0,0,2699,[],[]
345043291,AncapDawg,5,1,1,4,0,4309,[],[]
1630909045,BrentDyer3,0,0,0,0,0,86,[],[]
894911371112046594,4FREEDOM12,0,0,0,0,0,982,[],[]
965116166,Mrsfishordie704,3,0,1,2,0,200,[],[]
142069321,miggyjerez,3,0,1,2,0,59,[],[]
588685816,danielleeee_15,0,0,0,0,0,931,[],[]
314324796,blessitjanet,0,0,0,0,0,3033,[],[]
366718336,lawsoncaleb,11,0,2,9,0,285,[],[]
1341255002,joe_shipman,14,3,2,12,0,3748,[],[]
869027394,seancduarte,3,0,1,2,0,2902,[],[]
787939766457274368,VarssonBen,0,0,0,0,0,396,[],[]
1161779674768388096,dolores80179419,4,1,3,1,0,811,[],[]
718582416378576896,MesMitch,37,3,8,29,3,15622,[],[]
1226924517546696704,arkansas_an,0,0,0,0,0,252,[],[]
19566701,estregeegee,4,0,1,3,0,3204,[],[]
747311943501807616,DanCook26214426,19,3,9,10,0,14709,[],[]
482410262,ShannonJReilly,3,0,0,3,0,360,[],[]
1292431378554945537,kermit_wallace,0,0,0,0,0,48,[],[]
21655390,philipjonathn,178,18,7,171,2,10420,[],[]
158617273,duke_prunes,0,0,0,0,0,647,[],[]
703977055,Merlot_italiano,1,3,0,1,0,407,[],[]
3979608593,ypusaidwhat,0,0,0,0,0,14,[],[]
825728106405183489,DivergentStream,0,0,0,0,0,486,[],[]
866830976671928320,RustyMalicoat,0,0,0,0,0,2,[],[]
1265400088605503490,jaykhanconforte,0,0,0,0,0,17,[],[]
1972212750,SportyGirlC,7,1,2,5,0,4424,[],[]
853646311941451778,Road_trippn,63,3,11,52,3,7036,[],[]
28922730,awaecha,0,0,0,0,0,24,[],[]
2750371554,DMFreeman777,5,1,0,5,1,159,[],[]
1028837748667547648,aDomestic17,14,3,2,12,0,2095,[],[]
517340884,johnjr82,0,0,0,0,0,583,[],[]
1295413519526092800,ActualKee,0,0,0,0,0,32,[],[]
627473661,jeffmcollins,22,1,7,15,0,681,[],[]
2929919972,richnoland1,1,0,0,1,0,49,[],[]
773624811113353216,hooper_milton,0,0,0,0,0,13,[],[]
14884986,aruthven,0,0,0,0,0,148,[],[]
1275434797729488897,HaroldS44170793,0,0,0,0,0,0,[],[]
937435211670974470,DelegateBagnall,6,1,1,5,0,1610,[],[]
1250947941512228864,AScubalax,0,1,0,0,0,0,[],[]
132277334,ChahtaCochise,16,2,0,16,0,980,[],[]
1003806103543705600,VerityWho,0,0,0,0,0,837,[],[]
8500212,ArtModern,0,0,0,0,0,966,[],[]
603068411,holt999,0,0,0,0,0,1921,[],[]
1268704802789298177,davidpaulNY,0,0,0,0,0,36,[],[]
1299353631632822278,PaulHel31562294,0,0,0,0,0,1198,[],[]
3257125194,catseyecouture,0,2,0,0,0,2551,[],[]
3422806901,KarenBlack59,0,0,0,0,0,75,[],[]
1328542328575946752,WConTheRoad,7,2,2,5,0,2878,[],[]
1281639692090454016,gore_won,107,10,22,85,5,19133,[],[]
1098989472354586624,FTWTMPS,1,0,0,1,0,678,[],[]
58637286,Golfpards,0,1,0,0,0,153,[],[]
800111181058838528,OMGno2trump,418,18,133,285,13,118221,[],[]
873802968633450496,CindyLouCoffey1,0,0,0,0,0,1292,[],[]
785861464104075264,EdAddendum,0,0,0,0,0,18,[],[]
826451723493449729,Pistolannie31,149,14,29,120,3,7833,[],[]
4235379015,MJ_Mouton,102,18,8,94,2,32224,[],[]
31488410,BleedingMarine,2031,101,273,1758,33,47626,[],[]
2590221818,RheinsbergTapes,0,0,0,0,0,464,[],[]
1345769991099084800,russ_gilliam,0,0,0,0,0,1,[],[]
899314254850936836,Dovahkirin,0,0,0,0,0,27,[],[]
27294328,ClueHeywood,283,34,23,260,2,50392,[],[]
2809353921,trcztunedn,1,0,0,1,0,10,[],[]
1226057739593486336,JamesRogerSmith,1,0,0,1,0,19,[],[]
1327298155638034432,BarbaraLaubent1,1,1,0,1,1,274,[],[]
1207050227208859654,NDuplissis,1,0,0,1,0,33,[],[]
19230782,Staxx09,3,1,1,2,0,2249,[],[]
398088661,MEPFuller,1019,42,125,894,8,243441,[],[]
567719406,RA_PaulHughes,3,0,0,3,0,2861,[],[]
4827378145,MikeLupica,326,12,29,297,2,39155,[],[]
840408109063499776,JohnnyF75507588,1,0,0,1,0,1270,[],[]
1085312687041589255,Phoebe89674553,0,0,0,0,0,131,[],[]
2917157697,TimMBr1,0,0,0,0,0,180,[],[]
294300657,LyndaObst,18,4,0,18,0,15972,[],[]
790652610512613376,RefslandCheryl,4,0,0,4,0,3465,[],[]
1107611467,TinaTbrg9900,2,0,0,2,0,2,[],[]
1343291873096568833,WCH76166560,0,0,0,0,0,3,[],[]
482190681,NanciAma,116,1,33,83,1,12123,[],[]
1346212206069895171,PogsNotPAWGs,0,0,0,0,0,0,[],[]
26960324,hedseeker,0,0,0,0,0,574,[],[]
1188898775571546112,SinsTalisman,1,0,0,1,0,506,[],[]
28425795,iStephenEvans,2,0,1,1,0,118,[],[]
21952044,Numbers28,1688,108,361,1327,40,55253,[],[]
1333368934477803521,olivetheclimber,0,0,0,0,0,27,[],[]
1182400902,dld64376621,6,0,1,5,0,2940,[],[]
329751300,SarahMAnderson1,18,0,2,16,1,1823,[],[]
382900974,slegrbombs71,0,0,0,0,0,726,[],[]
790588260661678080,chazzwozza,2,1,1,1,0,237,[],[]
57049313,cyfer13,1,3,0,1,0,333,[],[]
2598045721,ArtPixler,0,0,0,0,0,102,[],[]
1312164060746723334,Theodor49008836,2,0,0,2,0,3,[],[]
823577993150951424,KarenCotter14,0,0,0,0,0,459,[],[]
930851848260603904,LovePassant,5,0,1,4,0,2315,[],[]
2875819794,kiwibryntoo,0,0,0,0,0,3306,[],[]
581855323,jyrstyle,2,0,0,2,0,237,[],[]
709164050387632128,BethMor29083029,2,0,0,2,0,125,[],[]
69851063,Wolf_Wolfman,2,1,1,1,0,3287,[],[]
113490650,bengreenman,10,1,0,10,0,16136,[],[]
1190127297753300992,AndyFinnegan5,2,0,1,1,0,20,[],[]
832714666346369024,madmacmoe,0,0,0,0,0,212,[],[]
912103943269908480,ecrooksevan,1,0,0,1,0,16,[],[]
69708392,_SashaNicole_,0,0,0,0,0,964,[],[]
33642965,kbpowwow,0,0,0,0,0,101,[],[]
11408522,beowulf,57,14,6,51,0,12373,[],[]
1259604515101323270,TrumpPence4More,1,0,0,1,0,142,[],[]
28606521,SwaguarTV,4,1,0,4,0,2834,[],[]
197215449,DFlex2123,0,1,0,0,0,704,[],[]
1094779496908185602,Dan96965929,3,1,1,2,0,274,[],[]
18330216,radiobuff,0,0,0,0,0,803,[],[]
796779541482053636,Graciel32533307,0,0,0,0,0,45,[],[]
199786308,TheQuantumCat,1,1,0,1,0,841,[],[]
32667582,fathernathan,24,3,1,23,0,4278,[],[]
519585329,minnielabori,0,1,0,0,0,18,[],[]
341081471,brookins7878,0,0,0,0,0,51,[],[]
706229845848494080,RhoneLouviere,1,0,0,1,0,538,[],[]
18467337,swhobbit,1,1,0,1,0,97,[],[]
2314438411,CourtneyMovies,1,0,0,1,0,1705,[],[]
23031338,jlvhale,0,2,0,0,0,494,[],[]
788873581010624512,YayNarwhals,5,0,0,5,0,1910,[],[]
1031739687998816256,ScottLincoln19,19,0,7,12,2,1657,[],[]
16226910,BluedotGa,2,0,0,2,0,2016,[],[]
2462339132,ncommonsense,0,0,0,0,0,10037,[],[]
770348832160944128,CripCamper2020,14,3,2,12,0,13183,[],[]
304028382,Amenhotep_56,0,0,0,0,0,7,[],[]
3101828532,dpk71956,4,2,0,4,1,2082,[],[]
2787924265,Karmajun6,0,0,0,0,0,3,[],[]
2183042036,ArtBinhack,0,0,0,0,0,85,[],[]
347594318,stony225,2,0,0,2,0,5349,[],[]
1624121300,Word_Massager,3,0,0,3,0,2928,[],[]
2914114481,TimWCBD,1,1,0,1,0,1150,[],[]
16505411,je_mclaughlin,18,0,2,16,0,2968,[],[]
517263714,kay_fil,0,0,0,0,0,966,[],[]
42074224,lifesafeast,445,84,27,418,2,57344,[],[]
1329832879958884352,Ronniejoh1,1,0,1,0,0,514,[],[]
1342258148594225152,KevinDa12966375,0,0,0,0,0,2,[],[]
906620078,iSheeple1,36,8,8,28,3,29836,[],[]
774421707402555393,jimntexas6666,0,0,0,0,0,2,[],[]
1103100665952432129,Tuckerfan3,0,0,0,0,0,199,[],[]
1001525755233341440,FollowingtheT,0,0,0,0,0,1597,[],[]
932068755856936960,KylaInTheBurgh,4870,206,878,3992,94,64797,[],[]
16491157,SageBrightHeart,1,1,0,1,0,697,[],[]
1107125273454149633,LegateSprinkles,0,0,0,0,0,82,[],[]
2200784549,rowanchats,0,0,0,0,0,348,[],[]
3041632631,JustJeffW,0,0,0,0,0,168,[],[]
378318248,_Mauke_,3,0,0,3,0,241,[],[]
915225464230334464,jaws56429,0,0,0,0,0,1576,[],[]
1229920783130120193,LukeFromWisco,1,1,0,1,0,30,[],[]
500073781,TerieNorelli,6,0,1,5,0,4403,[],[]
890776404895334400,carolhlh,1,0,0,1,0,10,[],[]
27826793,ReubenHarper,0,0,0,0,0,4058,[],[]
1280597861726470146,DarthGueule,0,0,0,0,0,1,[],[]
17884701,RobBirdwell,0,0,0,0,0,381,[],[]
1222505436173275137,bogart_charlie,0,0,0,0,0,16,[],[]
1345554269794144256,triscuit69,3,5,1,2,0,4,[],[]
1055572285350989827,HavickJohn,0,0,0,0,0,46,[],[]
1162140975172640768,Bri4Change1,25,3,4,21,1,5682,[],[]
862652290536271872,MorceaseBeasley,20,0,0,20,0,3046,[],[]
824363707312570368,ghiggyluv,6,0,1,5,0,3448,[],[]
1473383838,JDLuckenbach,44,2,5,39,0,9375,[],[]
1075787051235205121,shakyee53,0,0,0,0,0,2,[],[]
32938052,vetnoceanside,0,0,0,0,0,493,[],[]
2515957569,nouseformonkeys,4,1,0,4,0,24,[],[]
1213881342917664768,trevorcumbo,7,1,1,6,0,801,[],[]
33024872,rumdawgg,1,0,0,1,0,95,[],[]
830237549268447233,AmericaDefiant,0,0,0,0,0,523,[],[]
14247236,funder,16435,191,2493,13942,104,1072524,[],[]
18340964,californilone,0,0,0,0,0,45,[],[]
1325188776776224769,ImChrisGordon,0,0,0,0,0,7,[],[]
176619668,hateGOP,25,0,8,17,1,16727,[],[]
269913457,dazyjane410,1,1,0,1,0,5187,[],[]
1097903622719979521,BrianLe96224246,0,0,0,0,0,1,[],[]
1330734676881727490,LanniMackenzie,0,0,0,0,0,10,[],[]
1267974175106334720,localbiiitch,0,0,0,0,0,2,[],[]
1276194404114423809,joy28wong,2,0,0,2,0,9,[],[]
965322473427226624,MartinDressel,0,0,0,0,0,1640,[],[]
277261996,Impolitics,121,4,17,104,3,17638,[],[]
2249578502,jbmerrifield,1,0,0,1,0,1487,[],[]
1259279420780613632,ToutSuiteSinner,13,4,1,12,0,10066,[],[]
1301376526282301440,swguillot,0,0,0,0,0,12,[],[]
14655334,dgchichester,1,0,0,1,0,618,[],[]
275765160,NowMediaScott,0,0,0,0,0,760,[],[]
938918778678710272,SarahSchoen22,0,0,0,0,0,637,[],[]
377443190,AnthonyJFuchs,0,0,0,0,0,1811,[],[]
270133481,Stormtracker666,0,0,0,0,0,100,[],[]
459636972,theAaffect,0,1,0,0,0,185,[],[]
59094070,dantivirus,1,0,0,1,0,1551,[],[]
105832336,fiercefreckled,6,0,1,5,0,31483,[],[]
794652195484565504,correctthemedia,141,4,28,113,2,23499,[],[]
1067448038489317383,TommieM99313448,0,0,0,0,0,37,[],[]
4724190433,reisnasty,0,0,0,0,0,8,[],[]
19947427,HelenKPDem,1,0,0,1,0,2089,[],[]
14426487,RabidBadger,5,0,1,4,1,2772,[],[]
17016364,Mark_H7781,2,1,0,2,0,72,[],[]
2176874390,erickson_allan,2,0,0,2,0,195,[],[]
33250147,Crackerthe4th,6,0,1,5,0,21552,[],[]
1329908178998362112,RonaldoAlva4,0,0,0,0,0,0,[],[]
18650281,dr0lst0n,92,5,20,72,0,86272,[],[]
3416806143,MckinnisAnthony,0,0,0,0,0,8,[],[]
93101050,sosacub,5,0,0,5,0,2344,[],[]
1195357026,noramauss,4,0,0,4,0,186,[],[]
33664590,PatrickDailey,8,3,0,8,0,3514,[],[]
198688169,swimmerbr78,285,6,43,242,1,40377,[],[]
806961923078160384,redmocd,1,1,0,1,0,123,[],[]
187386168,worlddrumNC,15,1,4,11,0,3536,[],[]
893220792942698496,CherylIngramSm1,0,0,0,0,0,79,[],[]
2880950984,Andhulse1,0,0,0,0,0,762,[],[]
127036157,Margoandhow,43,2,7,36,0,7931,[],[]
18639827,revelationplgrm,0,0,0,0,0,1534,[],[]
26258040,robhild,1,0,0,1,0,324,[],[]
935619995614285830,Liberty7Usa,0,0,0,0,0,92,[],[]
1038970825699774465,normboy562,252,14,65,187,3,4311,[],[]
245503017,PattiDyl,0,0,0,0,0,14,[],[]
22271087,nappingdragonn,10,0,3,7,1,339,[],[]
1326533089405833216,AlwaysVoteTruth,1,0,0,1,1,31,[],[]
1556427860,33agreed,4,0,0,4,0,2564,[],[]
1133100373252534274,ImAndrewMcManus,3,0,0,3,0,1179,[],[]
37101639,chicojimj,0,0,0,0,0,710,[],[]
1344678131676946434,ppstubbs2,0,0,0,0,0,16,[],[]
40388829,paated,1,0,0,1,0,2555,[],[]
17324167,girolamo5151,0,0,0,0,0,320,[],[]
26465563,MORNINGMANIAC,2,0,1,1,0,10604,[],[]
3137252856,upcountrydesign,0,0,0,0,0,995,[],[]
2387779440,LoriLorisuew,4,0,0,4,0,9263,[],[]
1020011513485189120,SuspendedTruth,0,0,0,0,1,172,[],[]
1447680306,LivingBlueinRed,21,0,2,19,0,13369,[],[]
2912176762,LindaRValentino,0,0,0,0,0,602,[],[]
1321613992054333440,BobNiswonger,0,0,0,0,0,4,[],[]
1279580158744072192,pbrown9999,0,0,0,0,0,333,[],[]
258358917,SCmusic82,591,36,195,396,17,20503,[],[]
47697628,Keauhou,1,0,0,1,0,407,[],[]
708480248028012544,MidAmericaNancy,0,0,0,0,0,7,[],[]
144325625,MauriceMichael,8,0,3,5,0,8579,[],[]
3018083097,LinSapCT,0,0,0,0,0,201,[],[]
165692068,corp_bigwig,7,2,0,7,1,360,[],[]
1325065471725461509,arianegad,1,0,0,1,0,0,[],[]
4043272469,OVJM_The_Branf,0,1,0,0,0,263,[],[]
153828164,TechDavid45,2,1,0,2,0,439,[],[]
804863192514039810,Kemmer43Philip,9,0,7,2,0,2,[],[]
897645545866502144,83501bpd,0,0,0,0,0,1352,[],[]
18517988,NWADoug,6,1,0,6,0,3584,[],[]
548703792,wendysuer,10,2,1,9,1,652,[],[]
1274741190559178758,joe_jo4,0,0,0,0,0,69,[],[]
823298214489038848,tessfortruth,0,0,0,0,0,2140,[],[]
1045405647322468357,Elizabe84800584,14,2,4,10,0,3921,[],[]
1284360658499391489,Breakfast_Fan,2,0,0,2,0,193,[],[]
1185910296717811712,PissdOff1,0,0,0,0,0,2,[],[]
2240777852,Markc2323,0,0,0,0,0,3644,[],[]
21825889,truthfinder888,0,0,0,0,0,696,[],[]
897784278356041730,Michele00821321,0,0,0,0,0,268,[],[]
14477295,zengonzo,0,0,0,0,0,358,[],[]
3959583873,brinkmnj,0,0,0,0,0,398,[],[]
1121413038865776641,BeroBret,0,0,0,0,0,66,[],[]
4789343926,Keithscott1220A,1,0,0,1,0,4,[],[]
763036897333678080,RoseanneTwisted,2,0,0,2,0,4309,[],[]
1273397437,davidalavender,1,0,0,1,0,99,[],[]
735986401007788032,MaryMorgan5150,4,0,0,4,0,190,[],[]
805559809445478401,Rover_Jae,10,0,0,10,0,3834,[],[]
1236416377109581826,NanafanafoBrina,1,0,0,1,0,70,[],[]
125654541,GSEP794,0,0,0,0,0,110,[],[]
874347976151498752,OccoquanDean,3,0,0,3,0,8,[],[]
1332530082682986497,HighOnAMountai1,1,0,0,1,0,540,[],[]
470746940,Domer1976,0,0,0,0,0,4630,[],[]
3258973388,RealBlueDuran,2,0,0,2,0,763,[],[]
175928410,silvercoug,49,3,8,41,2,2306,[],[]
171559155,ERIC_in_RVA,0,0,0,0,0,103,[],[]
21919758,southernrebella,0,0,0,0,0,177,[],[]
15883275,singlepayer,0,1,0,0,0,3390,[],[]
945816814596055041,jezebeljeffrey,0,0,0,0,0,61,[],[]
884098826709159936,mawesten321,17,0,6,11,0,3425,[],[]
1325244089462296576,ShotAnnie,0,0,0,0,0,1400,[],[]
2319144913,CMassaro723,1,0,0,1,0,361,[],[]
15913066,gintahar,1,0,0,1,0,1169,[],[]
30043148,kaylatausche,173,23,47,126,2,103020,[],[]
1591400760,TaraSetmayer,30386,290,2360,28026,92,161973,[],[]
1346118037259259904,TheLaneBailey,0,0,0,0,0,37,[],[]
2286239934,comicartharris,0,0,0,0,0,202,[],[]
1411455840,CCTXBOY361,0,0,0,0,0,220,[],[]
575032752,cameronnight11,17,0,3,14,0,463,[],[]
509513531,binksolutions,0,0,0,0,0,200,[],[]
1304115688735256577,pmharland1066,0,0,0,0,0,186,[],[]
956352938246529024,JH313T,0,0,0,0,0,0,[],[]
42780835,lousav760,0,0,0,0,0,630,[],[]
15182784,tioLechuga,0,0,0,0,0,21,[],[]
1258660774089801728,I_amBlueJay,177,10,42,135,2,14828,[],[]
810230914781507585,AmyAdamsOregon,6,2,0,6,0,442,[],[]
731976277217796096,clevjustice,3,1,0,3,0,127,[],[]
18360419,ThatOtherRBG,3,0,1,2,0,544,[],[]
195956735,bonniewelt,6,2,0,6,1,7587,[],[]
98206183,MxdUpShookUpGrl,0,0,0,0,0,366,[],[]
17979038,ct_la,2,1,0,2,0,2691,[],[]
18179659,MichaelMathes,1,0,0,1,0,4816,[],[]
1010136879130468352,Cup_of_Snarky,0,0,0,0,0,1623,[],[]
255689417,rmslim,3,0,0,3,0,18782,[],[]
785294432945917952,trcytait,0,0,0,0,0,109,[],[]
350513063,imdanajay,8,0,2,6,0,4286,[],[]
1111396866279833600,mauvesdeep,3,0,1,2,0,530,[],[]
151974122,thePoWer_RangeR,0,0,0,0,0,6063,[],[]
2310326000,lydon_hank,0,1,0,0,0,90,[],[]
1114285507435999234,Boy2020Patriot,0,0,0,0,0,598,[],[]
22596600,MrMokelly,125,12,11,114,1,17312,[],[]
938966173768650753,PMPM1095,1,1,0,1,0,2941,[],[]
81697512,YeahMyBad,2,1,0,2,0,368,[],[]
21147625,awbozzi,0,0,0,0,0,1715,[],[]
28127893,RealtorSullivan,0,0,0,0,0,1756,[],[]
972570055543226368,enamoredJoon,0,0,0,0,0,22,[],[]
1116081638008471552,ChakiFunkWizard,3,0,0,3,0,606,[],[]
1130489159137800193,kaylamarie_tv,4,0,0,4,0,769,[],[]
28202540,SparklayBarclay,1,0,0,1,0,407,[],[]
592048447,LukePettiB,0,0,0,0,0,58,[],[]
1640929196,mmpadellan,146287,3033,17366,128921,1490,922947,[],[]
1336745314812895237,citizen12141,2,0,0,2,0,2248,[],[]
32590294,Michaela_Cogs,1,0,0,1,0,490,[],[]
20802603,MattGlassman312,82,6,9,73,1,22150,[],[]
230935406,ivyarchive,1,0,0,1,0,469,[],[]
87196086,msmoon61,4,1,0,4,0,670,[],[]
296439887,Toshogu,2,0,0,2,0,299,[],[]
21660877,StephanieDhue,0,0,0,0,0,2422,[],[]
26643449,dananimal23,0,0,0,0,0,61,[],[]
1224406298,JakeBig10,0,0,0,0,0,15497,[],[]
175634922,DefiantREbell,0,0,0,0,0,101,[],[]
1265533849267822592,Xruadis,0,0,0,0,0,25,[],[]
1224377398470246402,NancyHenning15,2,0,0,2,0,33,[],[]
11740172,charlesjaco1,69,4,14,55,0,9028,[],[]
1325113852401340416,PeterBr21933236,0,0,0,0,0,4,[],[]
52576369,CindysClipboard,1,0,0,1,0,558,[],[]
957647411534532613,livn4wknd,0,0,0,0,0,71,[],[]
1380597385,ashleynthomp,1,0,0,1,0,3358,[],[]
1263567769,KFordCB9,40,5,2,38,0,1216,[],[]
767612947321524224,geeondruh,0,0,0,0,0,1005,[],[]
1151824428,RCCates,18,1,1,17,0,3224,[],[]
29983518,theLesleyDaunt,1,0,0,1,0,393,[],[]
386232032,RickDeacon1,5,0,1,4,0,504,[],[]
235719515,corimayhew_,1,0,0,1,0,703,[],[]
1024090359012384769,dallimore_m,4,1,1,3,0,1226,[],[]
36219653,Tshizzle01,0,0,0,0,0,91,[],[]
1158403766519029760,CassieInquiring,0,1,0,0,0,32,[],[]
754292880,mdsingla,0,0,0,0,0,4,[],[]
821072630191157248,InTrumpsBrain,0,0,0,0,0,28,[],[]
16855698,SanbornJF,2,0,0,2,0,1225,[],[]
46830858,infamyscallywag,0,0,0,0,0,451,[],[]
21407747,ArsOculorum,0,0,0,0,0,414,[],[]
228115968,jcasst,0,0,0,0,0,11,[],[]
180997981,EllieMSennett,0,0,0,0,0,946,[],[]
1033751995184762880,LanceUSA70,203,6,31,172,0,86081,[],[]
1326263845585883137,Mustang179,0,0,0,0,0,8,[],[]
517903296,TroyBrady2,0,0,0,0,0,31,[],[]
409008285,StockWrecker,0,0,0,0,1,1081,[],[]
1074326237529534466,MichaelLewall10,0,0,0,0,0,40,[],[]
1102723628,DeanSanford1,3,0,0,3,0,63,[],[]
19859876,JanvierUK,0,0,0,0,0,380,[],[]
61804549,jaykayweek,2,0,0,2,0,40,[],[]
406595268,JohnKeller15,16,1,4,12,0,23969,[],[]
821787431896776706,ChurningPoint,0,0,0,0,0,6,[],[]
114781864,Realmrssepia1,1,1,0,1,0,6391,[],[]
621996473,DavidBWriter,69,3,15,54,0,3921,[],[]
1220573421479874560,thatotallysucks,1,0,0,1,0,19,[],[]
251754138,URTheBank,0,0,0,0,0,1519,[],[]
97218660,RLFITZ,0,1,0,0,0,104,[],[]
196759072,danb1a,2,0,1,1,1,1030,[],[]
2357297012,labyrinthweaver,2039,103,260,1779,27,56341,[],[]
22843967,jim1fletcher,0,0,0,0,0,328,[],[]
1195153726127955968,uwillsee73,1,0,0,1,0,9,[],[]
1068554096,ProvostQuigley,1,0,0,1,0,304,[],[]
18444804,TCBGP,5,0,0,5,0,4548,[],[]
1035948712500056066,robertjdenault,3759,103,732,3027,39,57280,[],[]
105158278,DoctorGoatMD,1,0,0,1,0,137,[],[]
200131437,TxCrusaders,10,2,0,10,0,2258,[],[]
36390992,queenvelyn,0,0,0,0,0,220,[],[]
2266705333,SayyedEdward,0,0,0,0,0,4591,[],[]
872245007390060545,parker_dale16,15,0,1,14,0,273,[],[]
85263350,ekelly1,0,0,0,0,0,139,[],[]
302556418,Aventuramango,50,1,6,44,0,7404,[],[]
1190864283372003329,MichaelSkadoosh,3,0,0,3,0,1259,[],[]
743309804219731969,louie_tran,4,0,0,4,0,2954,[],[]
1852319167,Hahns46,0,0,0,0,0,8613,[],[]
422914491,Ultron1983,0,0,0,0,0,2506,[],[]
1240699886535835648,midwitchediting,0,0,0,0,0,565,[],[]
1247951832774848514,GreenInSeaOfRed,0,0,0,0,0,7,[],[]
12284602,jhurshman,0,1,0,0,0,47,[],[]
278116450,_carolineamos,8,0,0,8,0,408,[],[]
32872326,134Lounge,0,0,0,0,0,172,[],[]
1037257517347360770,LordKissypants,9,3,0,9,0,1768,[],[]
223062543,mackenzielabrie,0,0,0,0,0,164,[],[]
257362810,LavoraBarnes,42,1,7,35,1,14996,[],[]
14962779,howardfineman,469,22,80,389,5,255467,[],[]
1078111548,RMPhotography_2,0,0,0,0,0,29,[],[]
130446423,zedisacorpse,0,0,0,0,0,1119,[],[]
28031607,Stratamar,0,0,0,0,0,231,[],[]
472831408,IsaacLamb,0,0,0,0,0,931,[],[]
17640519,rwright55,0,0,0,0,0,151,[],[]
1339222257978265602,KimberStue,0,0,0,0,0,36,[],[]
1325834673667256320,VegasStrong13,2,0,0,2,0,2411,[],[]
18109429,scientificrealm,569,32,48,521,7,24163,[],[]
1210275660482007040,hamdolo1,0,0,0,0,0,104,[],[]
289442042,Groceryhound,0,0,0,0,0,703,[],[]
1283554372765446144,mcgriff_dexter,2,0,0,2,0,30,[],[]
223559591,JuanSVas,1,0,1,0,1,3063,[],[]
1092025782,ThatGirlFinley,5,1,1,4,0,253,[],[]
16349891,lparsoni,1,0,0,1,0,1003,[],[]
1343758727787122690,CarlDav53656098,0,0,0,0,0,4,[],[]
824626262991917058,FrankCoulson7,0,0,0,0,0,3787,[],[]
167551071,BayayKnipps,2,1,0,2,0,165,[],[]
411684872,joeyDosik,15,0,0,15,1,10073,[],[]
1058176286827446272,Jackson30886934,0,1,0,0,0,747,[],[]
3309589301,my2centsamerica,52,5,16,36,4,1436,[],[]
761654511312179200,fletchda56,2,1,1,1,0,123,[],[]
8660342,Sea_Dub,0,0,0,0,0,246,[],[]
1272522525336113152,thatstrue24,0,0,0,0,0,27,[],[]
711393652421955585,Rosa1234tejana,0,0,0,0,0,2554,[],[]
131017492,expect_truth,0,0,0,0,0,5,[],[]
1337583450396774405,yessir_yk,0,0,0,0,0,93,[],[]
1113255979,Lizzy1433,20,1,2,18,3,5727,[],[]
976956282065190912,hair_by_keaton,151,2,6,145,0,4015,[],[]
1195450939,spitterati,4,0,1,3,0,6103,[],[]
1326886675713286148,Antifa_Science,0,0,0,0,0,140,[],[]
14820509,waltb31,40,4,15,25,1,15048,[],[]
68513262,Arethusa13,0,0,0,0,0,1276,[],[]
1128357733,boredERdoc,1,0,0,1,0,4917,[],[]
131717792,justagrrlinny,0,0,0,0,0,200,[],[]
14802013,twilight2000,0,0,0,0,0,1665,[],[]
1095425102848634880,sagrorud,1,0,0,1,0,45,[],[]
248441880,PeterMAmbler,17,1,4,13,0,5895,[],[]
1037471108059078656,gangsy369,8,0,0,8,0,418,[],[]
1310024485983092736,MRafsanZ,0,1,0,0,0,0,[],[]
565030325,gar_brad,2,2,0,2,0,612,[],[]
27775683,BAWSE_NIKE,0,0,0,0,0,559,[],[]
906149115058413573,YossiSchlussel,10,2,1,9,3,1576,[],[]
1336852237121802240,jimcarr93571307,0,0,0,0,0,22,[],[]
21773998,ChrisHayner,11,0,1,10,0,3831,[],[]
1198241705675411457,MurphyYuiko,6,2,1,5,1,2236,[],[]
704552155101810688,Jack_Spiess_,2,0,0,2,0,143,[],[]
1313892494170632199,RaeGielau12,0,0,0,0,0,311,[],[]
461417568,AnEvanBruno,1,0,0,1,0,59,[],[]
1151246721877520393,jim06119852,0,0,0,0,0,8285,[],[]
17205177,exoticona,0,0,0,0,0,10,[],[]
41648889,MomMusic,3,0,0,3,0,1026,[],[]
2236300628,Cooper93Tina,0,0,0,0,0,5,[],[]
77513667,lrmagnusson,1,0,0,1,0,89,[],[]
16478480,Donno389,0,0,0,0,0,1229,[],[]
1248620524860608512,cypherx19,0,0,0,0,0,9,[],[]
816669855952814081,ride1hour,2,1,0,2,0,7415,[],[]
304719519,alirichthem,8,1,1,7,0,1608,[],[]
19500844,MikeSigner,8,0,2,6,1,10373,[],[]
817525296387723264,semcbride100,0,0,0,0,0,12,[],[]
90271269,tetsumonchi,0,0,0,0,0,124,[],[]
788100118704717824,0spfinsib,0,0,0,0,0,6765,[],[]
771464266759098368,Amy_WB,25,1,3,22,1,835,[],[]
995457077698023424,DrakNsfw,0,0,0,0,0,70,[],[]
15320603,CNNValencia,74,5,17,57,3,29559,[],[]
18705657,warrencdailey,2,0,0,2,0,296,[],[]
965775551058366464,jerry_linse,0,0,0,0,0,490,[],[]
1174104096686690304,she_obey,15,1,0,15,0,1469,[],[]
392176592,DohjaSoulja,0,0,0,0,0,17,[],[]
527593896,LanceKern,58,2,8,50,1,15285,[],[]
14182884,JustCallMeJamie,1,1,0,1,0,400,[],[]
2505322214,joieM13,0,0,0,0,0,1,[],[]
101271058,v12merlin,0,1,0,0,0,179,[],[]
1254536381457510402,lil___bosh,1,0,0,1,0,9,[],[]
910159252387491840,idiotnedelkoff,0,0,0,0,0,11,[],[]
1242183329157271552,danielt83659302,0,0,0,0,0,19,[],[]
1132660214732337152,EdwardCaddis,9,0,0,9,0,2536,[],[]
1048557709317103616,WolfVermilion,1,0,0,1,0,201,[],[]
16409048,rdmorris,4,1,0,4,0,1329,[],[]
20754647,ricbruce,2,1,1,1,0,203,[],[]
4879398573,transcendyou,0,0,0,0,0,583,[],[]
212970680,RealGeraldNorth,0,0,0,0,1,284,[],[]
1343993141238628352,catsmkgoodfrnds,0,1,0,0,0,407,[],[]
766103633465315328,DrMaggieWells,1,1,0,1,0,166,[],[]
797602006944911360,bassman_wayne,1,0,0,1,0,153,[],[]
1280817426,Diana071037,2,0,0,2,0,2441,[],[]
2794618440,FantasyDocDude,0,0,0,0,0,3360,[],[]
188102879,Hartman_MattB,2,0,0,2,0,46,[],[]
787037816962285569,whaditizzz,2,0,0,2,0,4572,[],[]
223197801,kenkis1988,0,0,0,0,0,4620,[],[]
1328466888733708288,AndreGouverneu3,0,0,0,0,0,90,[],[]
123702996,Faded_Off_Jen,3,1,1,2,0,1520,[],[]
1046076755507699712,Ian91141,0,0,0,0,0,350,[],[]
860675720695042048,Gillis9Rose,2,0,0,2,0,2408,[],[]
1257967838,TweetsForBeth,0,0,0,0,0,32,[],[]
899625090274512896,brian_h_reich,0,0,0,0,0,24,[],[]
31621164,Nimasema,0,0,0,0,0,1136,[],[]
2993853937,AFelixMedia,13,2,0,13,0,1702,[],[]
1333986134272192512,VVMusic3,1,2,0,1,0,397,[],[]
1277435352551129089,johndoewhodat,0,0,0,0,0,11,[],[]
7352262,jlhopwo,0,0,0,0,0,967,[],[]
1237187226813042690,rlpatt1967,0,0,0,0,0,45,[],[]
43413964,shyascanlon,2,0,0,2,0,1032,[],[]
371465104,RobertGBeckel,57,45,5,52,4,113693,[],[]
17398150,paaronson,0,0,0,0,0,6,[],[]
1211418246550716416,big_gay92,9,0,0,9,0,584,[],[]
11856892,MeetThePress,201,21,50,151,7,660458,[],[]
1238898850540158983,fernwoodsson,2,0,0,2,0,825,[],[]
1239954447972761600,GassiMichael,0,0,0,0,0,49,[],[]
2493050420,mschoneman58,0,0,0,0,0,0,[],[]
574572567,annabellee_lee,12,1,3,9,2,910,[],[]
1337436710477713410,Burleythecat,0,0,0,0,0,336,[],[]
14413466,RalstonReports,141,7,22,119,1,143799,[],[]
1041455040467267584,RickySunnyvale1,1,0,1,0,0,465,[],[]
3408513395,CelestineBee,6,0,2,4,0,21379,[],[]
1011375634726227968,JamPolitical,0,0,0,0,0,258,[],[]
1337780526980026370,RobertFromUtah,0,1,0,0,0,27,[],[]
765237275386970112,tipsyviolet,33,1,2,31,0,2042,[],[]
16257494,lew_jeffrey,1,0,0,1,0,981,[],[]
269903211,quixxdraw,1,0,0,1,0,1043,[],[]
1343405953115250688,infosecthought1,1,0,1,0,0,48,[],[]
269405840,MrsSMartingale,0,0,0,0,0,106,[],[]
52052011,govtrack,166,6,31,135,8,102725,[],[]
1328177101405609984,DianaPo21210840,0,0,0,0,0,2,[],[]
18246476,Qwiickk,4,0,1,3,0,72,[],[]
552475782,Sarcastic_hubby,0,1,0,0,0,386,[],[]
1234133807328112640,LincolnBDrinkin,3,0,0,3,0,2992,[],[]
82360403,HauteTravels,0,0,0,0,0,5929,[],[]
1114305369034170369,newswithdianna,0,0,0,0,0,17,[],[]
226264386,bobmeistre,0,0,0,0,0,3889,[],[]
34812875,kyfanatic,1,0,0,1,0,190,[],[]
2269557301,owhy3,8,0,3,5,0,3222,[],[]
626682905,AndreaT2303,1,0,0,1,0,4290,[],[]
1321988770451787776,JackH43016,3,0,0,3,1,7,[],[]
24025273,LindaOsborne60,0,0,0,0,0,200,[],[]
63211254,JorgenThelin,0,0,0,0,0,396,[],[]
93976042,Johnmcurtis,11,1,3,8,1,7109,[],[]
784556225073733635,JVDyne,0,0,0,0,0,105,[],[]
55751928,SocraticSage,0,0,0,0,0,588,[],[]
91882544,DineshDSouza,127248,5305,22226,105022,3296,1990431,[],[]
989793715249180672,gramma_smith,6,1,0,6,0,1215,[],[]
1026698916702691333,KissFixediT,6,0,2,4,1,3358,[],[]
2571956359,SYTweetGirl,0,0,0,0,0,1132,[],[]
334728365,ToddKettler,2,0,0,2,0,550,[],[]
1015618792775446529,BarnowskyLarry,8,0,0,8,0,2974,[],[]
743445757945065472,Videl6000,0,0,0,0,0,41,[],[]
1108531525925199872,Cheeks1128,8,2,1,7,1,7342,[],[]
44369787,jean1924,0,0,0,0,0,7,[],[]
956216394412056576,AntonvWalraven,3,0,1,2,0,683,[],[]
152783253,twitemarti,0,0,0,0,0,581,[],[]
1254118660454694918,realsoberlatina,111,23,16,95,4,13450,[],[]
1883217847,Michele89566319,0,0,0,0,0,53,[],[]
1972579339,CubsFan4ever62,0,0,0,0,0,154,[],[]
54315703,RandallVC,10,0,1,9,0,23105,[],[]
152143889,MattyButts1,0,0,0,0,0,511,[],[]
1044661675100532736,RobertParmelee5,16,0,3,13,2,4005,[],[]
18945074,NewfangledDad,0,0,0,0,0,700,[],[]
182524533,docMJP,37,1,4,33,1,30719,[],[]
793057902,bobbydogmatics,1,2,0,1,0,629,[],[]
3292067449,smromaih,6,1,0,6,1,3830,[],[]
2988019469,larryslater12,0,0,0,0,0,3,[],[]
801656229277773826,s_kafalaj,0,0,0,0,0,1179,[],[]
148342326,TheEternalRival,0,0,0,0,0,328,[],[]
904733531640922113,TheREEEEingTard,0,0,0,0,0,3,[],[]
33362346,jimstinnett,0,0,0,0,0,223,[],[]
586723805,Run_the_numbers,0,0,0,0,1,175,[],[]
17231896,thedongo,0,0,0,0,0,57,[],[]
97561501,saucersource,0,0,0,0,0,296,[],[]
5861562,cereta,1,0,0,1,0,721,[],[]
3124541422,Papi_B_Dubs,1,0,0,1,0,10202,[],[]
1004027971,i1patrick,0,0,0,0,0,11,[],[]
988994788010745857,dr_skhargrove,0,0,0,0,0,5,[],[]
1257403874295586830,PCee52,179,103,23,156,9,22386,[],[]
19491023,hdurzy,0,0,0,0,0,684,[],[]
46275679,dfhall07,0,0,0,0,0,2001,[],[]
1959481567,RobertTocco,0,1,0,0,0,24,[],[]
139723958,LeeMNichols,5,2,1,4,0,1806,[],[]
762252876,BonkPolitics,35,3,8,27,0,3897,[],[]
1021238538761797632,alwayscanada,0,2,0,0,0,32,[],[]
270664041,Cie2011,4,0,2,2,0,3854,[],[]
365837853,wbakema,0,0,0,0,0,24,[],[]
945479671361269760,SimNewbyfan1,0,0,0,0,0,379,[],[]
2785090971,I_am_April_Lee,1,0,0,1,0,1148,[],[]
1033792754436984834,arcadeglitch_,7,2,0,7,0,2221,[],[]
929767406435733505,MAGAJulesS,0,0,0,0,0,1431,[],[]
1224868222572421121,locoashes,10,1,4,6,1,26418,[],[]
1329796715730309122,popularVote7,0,0,0,0,0,0,[],[]
557332311,GraspPutin,1,0,0,1,0,71,[],[]
635634718,OneBadNinjaGirl,0,0,0,0,0,155,[],[]
3588722174,zinos_richard,0,0,0,0,0,59,[],[]
812701941293842432,MsGoody2Shoes33,0,0,0,0,0,206,[],[]
821170435601612800,CheriTait1,0,0,0,0,0,5,[],[]
101586106,RealLeslieGold,0,0,0,0,0,494,[],[]
22139305,myan_rcrae,1,1,0,1,0,794,[],[]
827319022454714368,TannyTanTan_T,0,0,0,0,0,107,[],[]
962393508072927233,amandapanda_94,34,1,1,33,0,221,[],[]
1067260903,AmishSuperModel,377,19,43,334,1,60379,[],[]
1300495665152360448,HerHazyShades,1,0,1,0,0,10,[],[]
129534514,jwanyvette1,6,0,1,5,0,10987,[],[]
1330169231409885187,wineguru014,7,2,2,5,0,840,[],[]
1302441522164568064,i_veryin,0,0,0,0,0,631,[],[]
88736882,jamesh03,0,0,0,0,0,64,[],[]
20867800,rockstarmind,2,0,1,1,0,458,[],[]
875028788677136384,PierceFair89,1,1,1,0,0,889,[],[]
3178536802,MelissaStout12,0,1,0,0,1,1838,[],[]
1081286317399592960,ColinCorgi,49,2,0,49,0,1212,[],[]
886135349600243714,johnmkrohn,0,0,0,0,0,6,[],[]
1270091347572043778,Zelda07785721,0,0,0,0,0,0,[],[]
888506423923146752,bonhoefferchild,95,6,17,78,1,1038,[],[]
1341669418733023233,Glenz46879237,0,1,0,0,0,17,[],[]
4531371,LIfe_Love_Honey,0,0,0,0,0,287,[],[]
1179037698687934465,rouleau36,0,0,0,0,0,49,[],[]
23617145,redrivergrl,4,0,1,3,0,4913,[],[]
212549215,SpencerMagne,24,2,3,21,0,3990,[],[]
23030894,gr8lakesgirl68,0,0,0,0,0,91,[],[]
829445587896524820,Waxxmann2,0,0,0,0,0,1757,[],[]
868594676500234240,lucasgarcia0221,0,0,0,0,0,1,[],[]
91368753,VictorRiley,0,1,0,0,0,66,[],[]
96153150,stevenmtobin,0,0,0,0,0,60,[],[]
1663427431,ecrire831,12,2,2,10,0,2209,[],[]
18684946,davequast,5,1,1,4,2,8092,[],[]
999835392936296448,mkpatriot1952,0,0,0,0,0,309,[],[]
1341718935155044355,StacyWoody4,0,0,0,0,0,4,[],[]
810616252049870852,damatodocd,0,0,0,0,0,1,[],[]
871131860226539521,MaskedFan3000,0,0,0,0,0,314,[],[]
346978404,canohughess,5,0,1,4,0,455,[],[]
875098446226706436,LegalsOnlyInUSA,0,0,0,0,0,4183,[],[]
831884713564463107,thortallmon,1,0,1,0,0,271,[],[]
75880875,David_E_Powell,0,0,0,0,0,488,[],[]
99840543,Thecameronliner,2,0,0,2,0,268,[],[]
1257283789748830208,Austin67977120,0,0,0,0,0,0,[],[]
24454045,alijomadden,1,0,0,1,0,157,[],[]
742061164142690304,rob0719,0,1,0,0,0,689,[],[]
832321192627470337,politcophilia,0,0,0,0,0,242,[],[]
35362949,IamLita,0,1,0,0,0,338,[],[]
253182943,sailinjackvip,3,1,1,2,1,32709,[],[]
920022718472445952,CRG678,0,0,0,0,0,864,[],[]
27326946,leahsadoian,16,0,2,14,0,558,[],[]
25838452,stgeller4,0,0,0,0,0,219,[],[]
1163614558558146560,TraderAnthony,2,0,1,1,0,4,[],[]
66498005,Kollar2015,0,0,0,0,0,45,[],[]
16156157,UPTOWNGIRL2008,21,1,5,16,2,14610,[],[]
1923535184,vinprod,2,0,2,0,0,2535,[],[]
114408761,NagyEric,2,0,0,2,0,911,[],[]
755677202,NathanLerner,2406,38,581,1825,26,75352,[],[]
18668110,Now_Abhi82,0,0,0,0,0,380,[],[]
564947096,SouthernCoca,46,5,5,41,2,42315,[],[]
22274674,mooielouie,1,0,0,1,0,2437,[],[]
1686825300,pfeiffer0395,0,0,0,0,0,54,[],[]
762024240,REMASCULATE,155,42,22,133,5,34487,[],[]
24093715,TyJuanOn,1,0,0,1,0,2228,[],[]
38187699,textually,0,0,0,0,0,4248,[],[]
706313572079394816,rioricki,0,0,0,0,0,13,[],[]
206815044,DanielSerwer,0,0,0,0,0,7082,[],[]
916382586213228544,idlepundit,0,1,0,0,1,665,[],[]
716974856,ImCuckerTarlson,0,0,0,0,0,92,[],[]
192759166,JollyCAL19,4,0,1,3,0,145,[],[]
3981622154,ExploreWander,0,0,0,0,0,71,[],[]
890257862,jbenton62,1,0,0,1,0,23,[],[]
17892970,TraciiGuns,511,45,17,494,2,53353,[],[]
47368656,Kemji,1,0,1,0,0,2439,[],[]
3329517119,fifty3percent,0,0,0,0,0,1375,[],[]
280541103,heffstl,0,0,0,0,0,221,[],[]
148529707,RBReich,196890,4515,35001,161889,3129,1485611,[],[]
17582486,eshap,30,3,8,22,1,17412,[],[]
766052262,Pat_thinks_,5,3,3,2,0,7818,[],[]
50905849,shakeli,1,0,0,1,0,2390,[],[]
125530981,BENJAMINxKNIGHT,5,0,1,4,0,456,[],[]
249115282,MiaMarieMacy,3,0,0,3,0,1174,[],[]
1930541856,stevenbcohen1,0,0,0,0,0,25,[],[]
19203426,bradbatt,645,66,55,590,8,19516,[],[]
1326279070141849601,USAPATRIOT0164,11,1,2,9,0,2083,[],[]
1339759101694398464,BrandonGier1,4,0,1,3,0,653,[],[]
24124209,ccambron,0,0,0,0,0,114,[],[]
18520624,mysticmaverick,0,0,0,0,0,1057,[],[]
888092372428627968,KevinBartlettJr,0,0,0,0,0,43,[],[]
1321409938112057349,93Bradlee,0,0,0,0,0,1,[],[]
14889465,Justsomedust,4,2,0,4,0,352,[],[]
1257513717572554754,Corrine10877774,0,0,0,0,0,36,[],[]
991480229683236865,DonaldTurk10,1,0,0,1,0,203,[],[]
1288938826841427969,JHOLLA47085257,2,1,1,1,0,25,[],[]
376372170,zimbloggy,0,0,0,0,0,223,[],[]
2463968737,mlcoor70,0,0,0,0,0,279,[],[]
1345174003800035331,Stormtrooper5o1,26,1,6,20,1,338,[],[]
159506166,BeerTheDeer,0,1,0,0,0,263,[],[]
206603052,mkultrafilter,3,1,0,3,0,1089,[],[]
827605982721212416,TLoFairMinded,0,0,0,0,0,6,[],[]
16434028,gabbilevy,0,0,0,0,0,2434,[],[]
2573204630,Frank53025043,0,0,0,0,0,4,[],[]
817890498245488640,mayzeesMom,2,0,0,2,0,11872,[],[]
1292211889489862661,loudclown,1909,162,258,1651,77,17311,[],[]
824125823590535169,PearsonKMiller,0,1,0,0,0,22,[],[]
74883346,andyisbell,0,0,0,0,0,98,[],[]
386400641,MabryWilkinson,0,0,0,0,0,190,[],[]
3296142256,leadahorse2,11,0,2,9,1,9185,[],[]
402222954,McBarb210,0,0,0,0,0,301,[],[]
26458435,DanRodricks,5,2,0,5,0,26249,[],[]
145881080,deenews421,10,0,1,9,0,432,[],[]
30165029,SadieEllis,0,0,0,0,0,839,[],[]
49853083,gophawaii,55,5,12,43,2,6843,[],[]
275639373,jannaherbison,2,1,0,2,0,927,[],[]
201857000,PrezFaceBush,1,1,0,1,0,716,[],[]
440828361,markhpalermo,1,0,1,0,0,1588,[],[]
1345729158991802369,Realworldpolit1,1,0,0,1,0,4,[],[]
1328417102819188746,AssusReamus,11,3,1,10,0,48422,[],[]
249971367,HiSlowmo,0,0,0,0,0,75,[],[]
29708395,macartwright,0,0,0,0,0,375,[],[]
809527767146655744,rwalton67,0,0,0,0,0,1248,[],[]
1332502539653287938,Lover33Trump,0,0,0,0,0,13,[],[]
1233546358872821760,CherylWoolf4,0,0,0,0,0,1,[],[]
883377334056873984,al_bryant17,1,0,0,1,0,15,[],[]
34335476,BlaqkPhoenix777,0,0,0,0,0,335,[],[]
480049916,DCK_III,0,1,0,0,0,412,[],[]
705100457539084288,lisa_studiom80,1,0,0,1,0,1599,[],[]
335461406,kensimonsHDWIB,1,0,0,1,0,76,[],[]
827893661203587075,wrongthinkradio,0,1,0,0,0,1268,[],[]
703756187511234560,TrumpTrainFL,1,1,1,0,0,161,[],[]
814109352,ChrisCMahoney,0,0,0,0,0,114,[],[]
1299375816,LightfootGary,0,0,0,0,0,179,[],[]
2943944201,wiiisme,0,0,0,0,0,3,[],[]
1111993528719237120,strxwmxn,1,0,0,1,0,2220,[],[]
1145781366547714052,IThinker2022,0,0,0,0,0,981,[],[]
546110457,Vires_Num3ris,2,0,0,2,0,986,[],[]
1075153372062334976,ashlie_weeks,38,1,6,32,1,50637,[],[]
848678959969693698,CogNitocat,0,0,0,0,0,10616,[],[]
2286954991,Kruegzs1,0,0,0,0,0,5,[],[]
1337812546095624201,MinuteM43968054,0,0,0,0,0,2114,[],[]
511210135,TwittaChicca,20,2,7,13,2,5797,[],[]
1240041683456147456,idgy10,0,0,0,0,0,1196,[],[]
1059955969000644608,PebbleTweeting,0,0,0,0,0,8627,[],[]
18721430,mpapas,0,0,0,0,0,235,[],[]
65612846,debrahart20910,0,0,0,0,0,5,[],[]
145691451,Johnson_Cassie,0,0,0,0,0,1120,[],[]
11665282,GeorgeReese,7,1,2,5,0,9874,[],[]
540353181,docmikesmith,0,0,0,0,0,186,[],[]
749865517293277184,25Tulips,0,0,0,0,0,551,[],[]
275378900,vegasdude83,4,1,1,3,0,1353,[],[]
1294731092163952640,burn_loot,175,25,32,143,7,15977,[],[]
304133587,1mecross,0,0,0,0,0,1624,[],[]
1050876360892264449,andover_gary,14,1,2,12,1,13896,[],[]
1076403462,_saritamlopez,0,0,0,0,0,38,[],[]
1046523191609282561,Mzchawk1,0,0,0,0,0,571,[],[]
1014569926315700227,RonBalut,1,0,0,1,0,18,[],[]
1189936979816984576,MaryCor04834189,0,0,0,0,0,4,[],[]
39571095,dayclancy,630,10,104,526,9,1476,[],[]
1346107704671170560,EbertHeavy,3,0,1,2,0,136,[],[]
754813944,Andrew__Booth,3,0,0,3,0,675,[],[]
985273805223407617,hiyaharrison,17,1,2,15,0,286,[],[]
826146252266016768,farmer_mike_,0,0,0,0,0,1868,[],[]
2238600390,Ballroom801,0,0,0,0,0,58,[],[]
435085341,Delaney_Gee,0,0,0,0,0,106,[],[]
885678481077653504,from_sgf,0,0,0,0,0,277,[],[]
3347613317,KathyCournoyer2,0,1,0,0,0,383,[],[]
23150269,ThatShaneB,0,5,0,0,0,21043,[],[]
1240694739118292995,superokaybri,1,0,0,1,0,234,[],[]
19358191,nbatalha,13,0,0,13,0,9743,[],[]
62365344,The127Activist,1,0,0,1,1,1010,[],[]
2176754323,GBluedragon,0,0,0,0,0,133,[],[]
1345098669758902272,GalesNofilter,0,0,0,0,0,2,[],[]
2876041031,B52Malmet,17855,453,3076,14779,269,283158,[],[]
1139569256570470400,rungirlrun07,8,0,0,8,0,6340,[],[]
1225954493663072256,BuddyNeutral,0,0,0,0,0,1,[],[]
211540904,lunasandwichbot,9,2,1,8,0,334,[],[]
843863606655700992,DanDildy,4,0,1,3,0,625,[],[]
195138591,lioness60,0,0,0,0,0,2721,[],[]
4878610324,politvidchannel,1181,264,222,959,58,123427,[],[]
486166462,nordicmonte,1,0,0,1,0,2667,[],[]
1511968590,TonyInLaguna,0,0,0,0,0,8,[],[]
1298338840126672897,guitar4prez,0,1,0,0,0,49,[],[]
21775167,TimCJudd,1,0,0,1,0,9839,[],[]
822891416523304960,ShanRussell72,7,1,0,7,0,2724,[],[]
30541239,SaifQuadri,1,0,0,1,0,4062,[],[]
19559817,drala0722,2,0,1,1,0,5264,[],[]
825757017683943424,bambooshooti,14,1,2,12,0,17044,[],[]
1830582348,Tylerj800,0,0,0,0,0,61,[],[]
1321904844819582982,BabsMoore10,0,0,0,0,0,30,[],[]
811898225842159616,MalikObamaBot,0,0,0,0,0,91,[],[]
5474222,Clarsonimus,61,16,21,40,6,11581,[],[]
22941303,ChrisSchiffner,1,0,0,1,0,166,[],[]
32643442,okourgiantakis,181,6,49,132,1,5198,[],[]
2272300260,strujillo075,44,4,9,35,1,12437,[],[]
154990847,revnaps,0,0,0,0,0,50,[],[]
829825843719385088,NoumThe,0,0,0,0,0,1476,[],[]
375857937,realkaitlin,3,0,0,3,0,29,[],[]
89718749,NeilAxelrod,12,4,1,11,0,1576,[],[]
273234285,thisisforbruce,2,0,0,2,0,151,[],[]
395733263,PTom34,0,0,0,0,0,34,[],[]
78396305,NabilahforGA07,845,10,123,722,3,48849,[],[]
15284219,travkitty,0,0,0,0,0,251,[],[]
1113167519848783873,SarcasticOneTwo,0,0,0,0,0,1747,[],[]
1109835998928793603,jumahl3,2,0,0,2,0,628,[],[]
2614782182,IamJackBoot,70,1,17,53,0,12575,[],[]
1333633138736566272,ztechops,0,0,0,0,0,16,[],[]
28741851,wallacewang_com,0,0,0,0,0,84,[],[]
2562800055,glenn_mcneil,144,4,49,95,3,5767,[],[]
782348288875896833,mason13Erma,0,0,0,0,0,4,[],[]
220360751,mryanwilliams,0,0,0,0,0,312,[],[]
824554092022239232,VoasWa,0,0,0,0,0,378,[],[]
126011611,engravinggal01,0,2,0,0,2,525,[],[]
347988388,CJPS9624,0,0,0,0,0,3,[],[]
24457210,BizarreLazar,652,24,56,596,9,55422,[],[]
3241600946,derekticus,4,0,2,2,0,4144,[],[]
13837072,erinbrasher,4,2,0,4,0,1614,[],[]
2171040631,KansasMiddle,2,0,0,2,0,1441,[],[]
1336012834669547521,ByrneOlson,0,0,0,0,0,0,[],[]
492508362,MomHasHadIt,0,0,0,0,0,583,[],[]
1180172898163556352,WaymackR,8,0,2,6,0,3527,[],[]
837480361152106496,MichaelArt123,715,71,204,511,27,34385,[],[]
35427941,corey_dylan,5,0,1,4,0,640,[],[]
1192624068509519879,EvanRandolph17,0,0,0,0,0,270,[],[]
500465050,Proletariat_J,0,0,0,0,0,222,[],[]
1365441361,Anumbr1,5,0,2,3,0,1949,[],[]
991613369751867392,Phyllis94584953,329,92,87,242,22,11950,[],[]
20075759,ruhlworth,1,0,0,1,0,793,[],[]
10319952,Nerfzilla,0,0,0,0,0,3752,[],[]
1137358496821854211,Muhamma75575189,0,0,0,0,0,123,[],[]
1048232406468186113,TimLaws47262041,0,0,0,0,0,35,[],[]
2768271223,covie_93,1654,114,241,1413,26,97102,[],[]
1324854085523300357,RickSte66541605,1,0,0,1,0,14,[],[]
11265142,j363j,6,0,1,5,0,7700,[],[]
4075943843,SouthernGirlSC,0,0,0,0,0,53,[],[]
103967533,mediapython,0,0,0,0,0,2664,[],[]
1022264659024510976,beanbrightly,17,3,2,15,0,3144,[],[]
3035500603,AuraBlazeZ,4,0,0,4,0,473,[],[]
893659519749947392,JakeResist,0,0,0,0,0,432,[],[]
741035667136913408,Imwithherb,0,0,0,0,0,373,[],[]
1217254712522743809,YourNei47835923,1,0,0,1,0,318,[],[]
14370819,downwithtyranny,51,0,11,40,1,15259,[],[]
1289379162797547520,TrumpMustExpire,3,1,0,3,0,1284,[],[]
1276869632876576768,S19Tor,1,0,0,1,0,616,[],[]
48228484,jparrambide,0,0,0,0,0,330,[],[]
1309293250851856389,GilbertoRon6,0,0,0,0,0,1,[],[]
824063801347678208,Skywatcher1600,6,0,1,5,0,136,[],[]
2938756370,jpb103,2,0,1,1,0,60,[],[]
229892445,DNoFlo,0,0,0,0,0,13,[],[]
607023163,davidastur1,0,0,0,0,0,2,[],[]
20720943,doreenmartel,1,0,0,1,0,5041,[],[]
566533848,pop__fiend,2,1,0,2,0,649,[],[]
67478331,ack154,2,0,0,2,0,277,[],[]
120329401,matches42,1,0,0,1,0,116,[],[]
422055225,AllanBassett1,0,0,0,0,0,697,[],[]
1316065069076275201,Salchicha27,0,0,0,0,0,636,[],[]
362800632,deejsr,0,0,0,0,0,859,[],[]
450025350,MJalonschi,8,0,1,7,1,2202,[],[]
30395567,emrazz,799,18,69,730,1,229105,[],[]
17531057,Steve_Stuck,4,0,0,4,0,389,[],[]
103216375,JustaDumguy,0,0,0,0,0,344,[],[]
557334459,TimHannan,1549,27,198,1351,10,88161,[],[]
3439620198,presbycast,4,2,1,3,0,5282,[],[]
1219768217046077443,dirtyc0mmmie,0,0,0,0,0,102,[],[]
124473285,GraceUnderFiero,3,1,0,3,0,649,[],[]
906157795220840448,justimgold,0,1,0,0,0,22,[],[]
1216941396596338688,ChickMsu,2,0,0,2,0,373,[],[]
1343588410682986497,GuyFawk86006293,0,0,0,0,0,10,[],[]
32517594,RonSupportsYou,0,0,0,0,1,16744,[],[]
431038410,AliceCrandall,4,0,0,4,0,598,[],[]
